abaixar-la	abaixar la
abonar-se	abonar se
abordar-los	abordar los
absentar-se	absentar se
acabar-se	acabar se
accedir-hi	accedir hi
acceptant-la	acceptant la
acceptar-les	acceptar les
acollint-se	acollint se
acollir-la	acollir la
acollir-se	acollir se
aconseguir-ho	aconseguir ho
aconseguir-la	aconseguir la
aconseguir-lo	aconseguir lo
aconseguir-los	aconseguir los
acostar-se	acostar se
acostumar-nos	acostumar nos
actualitzar-lo	actualitzar lo
actuar-hi	actuar hi
adaptar-les	adaptar les
adaptar-me	adaptar me
adaptar-nos	adaptar nos
adaptar-se	adaptar se
adaptar-te	adaptar te
adequar-hi	adequar hi
adherint-se	adherint se
adherir-s'hi	adherir s hi
adherir-se	adherir se
adonar-se'n	adonar se ne
adormir-me	adormir me
adreçar-se	adreçar se
advertint-li	advertint li
afartar-se	afartar se
afegir-hi	afegir hi
afegir-nos	afegir nos
afegir-s'hi	afegir s hi
agafar-lo	agafar lo
agenollar-se	agenollar se
agrair-los	agrair los
agredir-lo	agredir lo
agreujar-se	agreujar se
aguantant-lo	aguantant lo
aixecar-li	aixecar li
ajudar-los	ajudar los
ajuntar-se	ajuntar se
ajustar-se	ajustar se
aliar-se	aliar se
alleujar-se	alleujar se
allunyar-se	allunyar se
amenaçant-la	amenaçant la
amenaçant-les	amenaçant les
amenaçant-lo	amenaçant lo
amenaçant-los	amenaçant los
amenaçar-lo	amenaçar lo
ampliar-ne	ampliar ne
analitzar-la	analitzar la
anar-hi	anar hi
anar-lo	anar lo
anar-se'n	anar se ne
animar-lo	animar lo
anomenar-se	anomenar se
anunciar-la	anunciar la
anunciar-li	anunciar li
anunciar-los	anunciar los
apadrinar-lo	apadrinar lo
apallissar-les	apallissar les
apartar-se	apartar se
aplicar-lo	aplicar lo
aplicar-los	aplicar los
apoderant-se	apoderant se
apoderar-se	apoderar se
apropar-se	apropar se
apropiar-se	apropiar se
aprovar-los	aprovar los
aprovar-se	aprovar se
aproximar-nos	aproximar nos
apujar-la	apujar la
apuntar-se	apuntar se
arrancant-li	arrancant li
arribar-hi	arribar hi
arxivar-lo	arxivar lo
assecant-se	assecant se
assegurar-se	assegurar se
assessorar-los	assessorar los
asseure'm	asseure me
asseure'ns	asseure nos
asseure's	asseure se
atendre-les	atendre les
atrapar-la	atrapar la
atrevir-se	atrevir se
atribuir-li	atribuir li
atribuir-se	atribuir se
aturar-lo	aturar lo
aturar-se	aturar se
autorevisar-se	autorevisar se
autoritzar-la	autoritzar la
avaluar-ne	avaluar ne
avaluar-se	avaluar se
avançant-ne	avançant ne
avisant-los	avisant los
baixar-lo	baixar lo
baixar-se	baixar se
banyar-se	banyar se
barallar-se	barallar se
basant-se	basant se
batre'l	batre el
beneficiar-se	beneficiar se
beneir-la	beneir la
buscar-los	buscar los
calmar-lo	calmar lo
calmar-se	calmar se
canalitzar-les	canalitzar les
cantar-hi	cantar hi
canviar-lo	canviar lo
captar-los	captar los
carregar-se	carregar se
casar-se	casar se
castigant-lo	castigant lo
causant-li	causant li
causar-li	causar li
celebrar-se	celebrar se
centrar-los	centrar los
citant-los	citant los
citar-la	citar la
citar-lo	citar lo
citar-ne	citar ne
classificar-les	classificar les
classificar-se	classificar se
clavant-li	clavant li
clavar-li	clavar li
cobrar-les	cobrar les
cobrir-lo	cobrir lo
colpejar-la	colpejar la
colpejar-ne	colpejar ne
col·laborar-hi	col·laborar hi
combatre'ls	combatre els
començar-se	començar se
comercialitzar-la	comercialitzar la
commemorar-ho	commemorar ho
comparant-lo	comparant lo
compartir-lo	compartir lo
compensar-los	compensar los
complir-se	complir se
comportar-se	comportar se
comunicar-li	comunicar li
comunicar-se	comunicar se
concentrar-se	concentrar se
concretar-se	concretar se
conduir-les	conduir les
conduir-lo	conduir lo
conduir-los	conduir los
coneixent-lo	coneixent lo
confiscar-li	confiscar li
confortar-los	confortar los
connectar-s'hi	connectar s hi
connectar-se	connectar se
consagrar-se	consagrar se
considerant-lo	considerant lo
considerar-la	considerar la
considerar-lo	considerar lo
considerar-los	considerar los
considerar-se	considerar se
consolidar-se	consolidar se
constituint-se	constituint se
construir-hi	construir hi
construir-ne	construir ne
construir-se	construir se
consultar-ho	consultar ho
consumar-se	consumar se
consumir-ne	consumir ne
contribuir-hi	contribuir hi
controlar-la	controlar la
controlar-les	controlar les
controlar-lo	controlar lo
convertir-la	convertir la
convertir-les	convertir les
convertir-lo	convertir lo
convertir-los	convertir los
convertir-nos	convertir nos
convertir-se	convertir se
conèixer-lo	conèixer lo
conèixer-ne	conèixer ne
conèixer-se	conèixer se
coordinar-ho	coordinar ho
coronar-se	coronar se
crear-los	crear los
creure's	creure se
curar-se	curar se
daurar-se	daurar se
decidir-ho	decidir ho
decidir-se	decidir se
declarar-se	declarar se
dedicar-se	dedicar se
defensar-se	defensar se
definir-se	definir se
deixant-m'hi	deixant m hi
deixar-ho	deixar ho
deixar-la	deixar la
deixar-li	deixar li
deixar-lo	deixar lo
deixar-los	deixar los
deixar-se	deixar -se
demanar-li	demanar li
demanar-los	demanar los
demostrar-me	demostrar me
demostrar-se	demostrar se
denunciant-lo	denunciant lo
denunciar-lo	denunciar lo
desaconsellar-m'ho	desaconsellar m ho
desarmar-se	desarmar se
desconnectar-ne	desconnectar ne
desconnectar-nos	desconnectar nos
descordar-li	descordar li
desenvolupar-los	desenvolupar los
desfer-los	desfer los
desfer-se	desfer se
desmoralitzar-los	desmoralitzar los
despertar-la	despertar la
despertar-se	despertar se
desplaçar-s'hi	desplaçar s hi
desplaçar-se	desplaçar se
despullar-se	despullar se
destacar-se	destacar se
destinar-lo	destinar lo
destruir-la	destruir la
destruir-les	destruir les
destruir-los	destruir los
desviar-se	desviar se
desvincular-se	desvincular se
detectar-se	detectar se
deteriorant-se	deteriorant se
dient-li	dient li
diferenciar-se	diferenciar se
dignificar-la	dignificar la
dir-li	dir li
dir-lo	dir lo
dir-los	dir los
dir-me	dir me
dir-ne	dir ne
dirigir-se	dirigir se
disculpar-se	disculpar se
discutir-se	discutir se
disparar-li	disparar li
distribuir-la	distribuir la
distribuir-lo	distribuir lo
distribuir-los	distribuir los
divulgar-la	divulgar la
donant-li	donant li
donar-la	donar la
donar-li	donar li
donar-lo	donar lo
donar-los	donar los
donar-los-les	donar los les
donar-ne	donar ne
donar-nos	donar nos
donar-se	donar se
dotant-los	dotant los
dotar-lo	dotar lo
dotar-los	dotar los
dotar-se	dotar se
dur-hi	dur hi
dur-la	dur la
dur-lo	dur lo
edificar-hi	edificar hi
editar-se	editar se
elevar-se	elevar se
eliminar-ne	eliminar ne
emancipar-se	emancipar se
emetre's	emetre se
emocionar-se	emocionar se
emportar-se	emportar se
encabir-hi	encabir hi
encasellar-nos	encasellar nos
encomanar-la	encomanar la
enderrocar-lo	enderrocar lo
endinsar-se	endinsar se
endur-se-la	endur se la
enemistar-se	enemistar se
enfilar-se	enfilar se
enfrontant-se	enfrontant se
enfrontar-se	enfrontar se
engreixar-se	engreixar se
ensenyar-li	ensenyar li
entendre's	entendre se
entendre-les	entendre les
entenent-la	entenent la
entrar-hi	entrar hi
entregar-l'hi	entregar l hi
entregar-se	entregar se
entrenar-se	entrenar se
entretenir-les	entretenir les
entrevistar-se	entrevistar se
enviant-la	enviant la
enviar-hi	enviar hi
enviar-li	enviar li
equiparar-los	equiparar los
equivocar-me	equivocar me
esborrar-li	esborrar li
escapar-se	escapar se
escoltar-lo	escoltar lo
escoltar-nos	escoltar nos
esforçant-nos	esforçant nos
especialitzar-nos	especialitzar nos
esperant-se	esperant se
essent-ho	essent ho
estalviar-se	estalviar se
estar-s'hi	estar s hi
estar-se	estar se
estendre'n	estendre ne
estendre's	estendre se
estimar-se	estimar se
estudiar-ho	estudiar ho
evacuar-lo	evacuar lo
evitar-ne	evitar ne
excusar-se	excusar se
executar-la	executar la
executar-lo	executar lo
exercir-la	exercir la
expandint-se	expandint se
explicar-ho	explicar ho
explicar-li	explicar li
explicar-los	explicar los
explicar-ne	explicar ne
explicar-nos	explicar nos
explorar-la	explorar la
exposar-los	exposar los
expressar-se	expressar se
extorsionar-lo	extorsionar lo
facilitar-la	facilitar la
familiaritzar-se	familiaritzar se
fent-ho	fent ho
fent-se	fent se
fer-hi	fer hi
fer-ho	fer ho
fer-la	fer la
fer-les	fer les
fer-li	fer li
fer-lo	fer lo
fer-los	fer los
fer-ne	fer ne
fer-se	fer se
ferir-los	ferir los
ficar-lo	ficar lo
ficar-me	ficar me
ficar-nos	ficar nos
ficar-se	ficar se
filmant-lo	filmant lo
forçar-ho	forçar ho
fotografiar-se	fotografiar se
frenar-ho	frenar ho
frenar-lo	frenar lo
fusionar-la	fusionar la
fusionar-se	fusionar se
garantir-ne	garantir ne
girar-se	girar se
gravar-ne	gravar ne
guanyar-se	guanyar se
habituar-se	habituar se
havent-hi	havent hi
haver-hi	haver hi
haver-ho	haver ho
haver-lo	haver lo
haver-ne	haver ne
haver-se	haver se
identificar-los	identificar los
identificar-me	identificar me
identificar-se	identificar se
imitar-lo	imitar lo
impedir-ho	impedir ho
implantar-se	implantar se
implicar-se	implicar se
imposar-li	imposar li
incidir-hi	incidir hi
incloent-hi	incloent hi
incloure-hi	incloure hi
incloure-la	incloure la
incomodar-nos	incomodar nos
incorporant-la	incorporant la
incorporar-lo	incorporar lo
incorporar-los	incorporar los
incorporar-se	incorporar se
informar-los	informar los
informar-se	informar se
iniciar-se	iniciar se
inscriure'ls	inscriure els
inscriure's	inscriure se
inserir-lo	inserir lo
inspeccionar-la	inspeccionar la
integrant-los	integrant los
intentar-ho	intentar ho
interceptar-lo	interceptar lo
interessar-se	interessar se
interpretar-les	interpretar les
interrogar-los	interrogar los
interrompre's	interrompre se
introduir-la	introduir la
introduir-li	introduir li
introduir-se	introduir se
invertir-hi	invertir hi
invitar-lo	invitar lo
jubilar-se	jubilar se
lamentant-se	lamentant se
lesionar-los	lesionar los
llegir-la	llegir la
llegir-lo	llegir lo
llençar-la	llençar la
lligant-la	lligant la
localitzar-les	localitzar les
localitzar-lo	localitzar lo
magnificar-lo	magnificar lo
manifestar-se	manifestar se
mantenir-lo	mantenir lo
mantenir-se	mantenir se
maquillar-se	maquillar se
masturbar-lo	masturbar lo
matar-lo	matar lo
millorar-ne	millorar ne
mirar-la	mirar la
mobilitzar-se	mobilitzar se
morir-me	morir me
mossegant-lo	mossegant lo
mostrar-li	mostrar li
mostrar-se	mostrar se
movent-nos	movent nos
multiplicar-la	multiplicar la
muntar-s'ho	muntar s ho
negant-la	negant la
negar-se	negar se
nodrir-se	nodrir se
oblidant-se	oblidant se
obligar-la	obligar la
obligar-lo	obligar lo
obrint-li	obrint li
obrir-los	obrir los
obtenir-ho	obtenir ho
obtenir-lo	obtenir lo
oferir-la	oferir la
oferir-les	oferir les
oferir-los	oferir los
oferir-se	oferir se
oficialitzar-lo	oficialitzar lo
omplir-lo	omplir lo
oposar-se	oposar se
ordenar-li	ordenar li
organitzar-me	organitzar me
orientar-los	orientar los
pagar-li	pagar li
pagar-lo	pagar lo
pagar-los	pagar los
participar-hi	participar hi
passar-ho	passar ho
passar-se	passar se
penedir-me	penedir me
penetrar-la	penetrar la
pentinant-la	pentinant la
perdre's	perdre se
perdre-les	perdre les
perdre-li	perdre li
permetre-li	permetre li
perseguir-lo	perseguir lo
personar-s'hi	personar s hi
personar-se	personar se
petar-se	petar -se
plagiant-les	plagiant les
plantar-hi	plantar hi
plantejar-la	plantejar la
plantejar-se	plantejar se
plegar-se	plegar se
poder-hi	poder hi
poder-ho	poder ho
poder-la	poder la
poder-lo	poder lo
poder-los	poder los
portant-la	portant la
portar-les	portar les
portar-lo	portar lo
portar-los	portar los
portar-me	portar me
posant-li	posant li
posar-hi	posar hi
posar-ho	posar ho
posar-lo	posar lo
posar-se	posar se
posicionar-se	posicionar se
possibilitar-ne	possibilitar ne
potenciar-lo	potenciar lo
practicar-li	practicar li
preguntar-li	preguntar li
preguntar-se	preguntar se
prendre'n	prendre ne
prendre's	prendre se
prendre-la	prendre la
prendre-li	prendre li
preocupar-se	preocupar se
preparar-lo	preparar lo
presentar-lo	presentar lo
presentar-s'	presentar s'
presentar-se	presentar se
pressionar-los	pressionar los
prestar-se	prestar se
preveure'n	preveure ne
proclamar-lo	proclamar lo
projectar-la	projectar la
promocionar-se	promocionar se
pronunciar-se	pronunciar se
propinar-li	propinar li
protegint-se	protegint se
protegir-se	protegir se
provocant-li	provocant li
provocar-li	provocar li
publicar-les	publicar les
quedar-me	quedar me
quedar-se	quedar se
queixar-me	queixar me
reanimar-la	reanimar la
recollir-ne	recollir ne
reconduir-los	reconduir los
reconduir-se	reconduir se
recordant-li	recordant li
recuperar-la	recuperar la
recuperar-se	recuperar se
reduint-se	reduint se
reduir-lo	reduir lo
reduir-los	reduir los
reequilibrar-la	reequilibrar la
reescriure'l	reescriure el
referint-se	referint se
referir-se	referir se
refugiar-se	refugiar se
regenerar-se	regenerar se
regirar-se	regirar se
regular-ho	regular ho
rehabilitar-los	rehabilitar los
reiterar-los	reiterar los
relacionar-se	relacionar se
remetre'ns	remetre nos
renegociar-ne	renegociar ne
renovar-lo	renovar lo
rentar-me	rentar me
repartir-se	repartir se
repetir-se	repetir se
reprendre'l	reprendre el
reprimir-la	reprimir la
reptant-se	reptant se
requerir-li	requerir li
reservar-se	reservar se
resituar-se	resituar se
resoldre-la	resoldre la
resoldre-les	resoldre les
respondre-les	respondre les
responsabilitzar-se	responsabilitzar se
retenir-ne	retenir ne
retirar-les	retirar les
retirar-li	retirar li
retirar-se	retirar se
retocar-lo	retocar lo
retornar-les	retornar les
retornar-lo	retornar lo
retratant-lo	retratant lo
reunir-se	reunir se
revocar-la	revocar la
robar-li	robar li
saber-ho	saber ho
saber-los	saber los
saber-ne	saber ne
saldar-se	saldar se
saltant-se	saltant se
saltar-se	saltar se
salvar-los	salvar los
seduir-los	seduir los
segrestar-la	segrestar la
seguir-les	seguir les
seguir-ne	seguir ne
sentir-se	sentir se
separar-ne	separar ne
ser-hi	ser hi
ser-ho	ser ho
ser-ne	ser ne
situant-se	situant se
situar-hi	situar hi
situar-la	situar la
situar-se	situar se
solidaritzar-se	solidaritzar se
solucionar-ho	solucionar ho
sortir-se'n	sortir se ne
sotmetre'ls	sotmetre els
sotmetre's	sotmetre se
subjectar-la	subjectar la
submergir-se	submergir se
substituir-la	substituir la
sumant-se	sumant se
sumar-hi	sumar hi
sumar-li	sumar li
sumar-s'hi	sumar s hi
suposar-li	suposar li
tancar-se	tancar se
tenir-hi	tenir hi
tenir-la	tenir la
tenir-los	tenir los
tenir-ne	tenir ne
tornar-les	tornar les
tornar-me	tornar me
tractant-se	tractant se
tractar-ne	tractar ne
tractar-se	tractar se
tramitar-la	tramitar la
traslladant-lo	traslladant lo
traslladant-los	traslladant los
traslladar-la	traslladar la
traslladar-lo	traslladar lo
traslladar-se	traslladar se
travessar-lo	travessar lo
treure'n	treure ne
treure's	treure se
treure-la	treure la
trivialitzar-la	trivialitzar la
trobar-hi	trobar hi
trobar-li	trobar li
trobar-lo	trobar lo
trobar-me	trobar me
trobar-se	trobar se
trobar-se-la	trobar se la
unir-se	unir se
usar-ne	usar ne
utilitzar-ne	utilitzar ne
valdre'ns	valdre nos
vendre's	vendre se
venir-nos	venir nos
vestir-los	vestir los
veure'l	veure el
veure's	veure se
veure-hi	veure hi
