abandonarlas	abandonar las
abandonándolo	abandonándo lo
abonarse	abonar se
abrirse	abrir se
abriéndose	abriéndo se
acercándose	acercándo se
acercársele	acercár se le
acomodándose	acomodándo se
acompañarle	acompañar le
acompañarse	acompañar se
acompañándose	acompañándo se
acoplandose	acoplando se
acoplarse	acoplar se
acreditándola	acreditándo la
activarlo	activar lo
actualizarse	actualizar se
acusarlos	acusar los
acusándosele	acusándo se le
adaptarla	adaptar la
adaptarlas	adaptar las
adaptarlos	adaptar los
adaptarse	adaptar se
adaptándolos	adaptándo los
adecuarse	adecuar se
adentrarte	adentrar te
adheriéndose	adheriéndo se
adicionándoles	adicionándo les
afectarles	afectar les
afianzándose	afianzándo se
afincarse	afincar se
afirmándose	afirmándo se
agotarse	agotar se
agradecerles	agradecer les
agradecéroslo	agradecér os lo
agradéceles	agradéce les
agregádosele	agregádo se le
agregándole	agregándo le
agregándolos	agregándo los
agujereándole	agujereándo le
ahorrarse	ahorrar se
aislarlo	aislar lo
ajustándose	ajustándo se
al	a el
alarmarse	alarmar se
alcanzarlo	alcanzar lo
alejandose	alejando se
alejarse	alejar se
aliarse	aliar se
alimentarse	alimentar se
alinearse	alinear se
alistarse	alistar se
alojarse	alojar se
alternándose	alternándo se
alzarse	alzar se
amarse	amar se
ampliarlo	ampliar lo
ampliarse	ampliar se
aplicarse	aplicar se
apoderarse	apoderar se
apreciarse	apreciar se
apreciándose	apreciándo se
aprenderse	aprender se
aprobarse	aprobar se
aprovechandose	aprovechando se
aprovecharlo	aprovechar lo
aprovechándose	aprovechándo se
apuntarse	apuntar se
armarse	armar se
arrancarle	arrancar le
arrebatándoselo	arrebatándo se lo
arreglandotelo	arreglando te lo
arrepentirme	arrepentir me
arrestarlo	arrestar lo
asegurarse	asegurar se
asesinarle	asesinar le
asignándole	asignándo le
asociarse	asociar se
atarlas	atar las
atenderles	atender les
atenderte	atender te
atraerse	atraer se
atravesarla	atravesar la
atándolos	atándo los
autorrecluirse	autorrecluir se
averiguarlo	averiguar lo
avisarles	avisar les
avisarme	avisar me
ayudarla	ayudar la
ayudarle	ayudar le
ayudarlo	ayudar lo
ayudarnos	ayudar nos
ayudarse	ayudar se
ayudándose	ayudándo se
añadiéndole	añadiéndo le
basarse	basar se
basándose	basándo se
bañarte	bañar te
beneficiarse	beneficiar se
bloqueándola	bloqueándo la
brindarle	brindar le
calentándose	calentándo se
calificándole	calificándo le
cambiarlos	cambiar los
cambiarse	cambiar se
cambiarte	cambiar te
cantarles	cantar les
cargarla	cargar la
cargarlas	cargar las
casarse	casar se
catalogarla	catalogar la
celebrarlo	celebrar lo
celebrarse	celebrar se
celebrándose	celebrándo se
centrarse	centrar se
cerrarle	cerrar le
cerrarse	cerrar se
cerrándose	cerrándo se
ceñirse	ceñir se
clasificarse	clasificar se
clasificándose	clasificándo se
cobrarnos	cobrar nos
cocinarlos	cocinar los
colgarse	colgar se
colocarla	colocar la
colocarlos	colocar los
combatirse	combatir se
comercializarse	comercializar se
comerse	comer se
comerte	comer te
cometerse	cometer se
comiéndolos	comiéndo los
compararse	comparar se
compartirlo	compartir lo
complementándolo	complementándo lo
comportarse	comportar se
comprarlos	comprar los
comprenderse	comprender se
comprobarlo	comprobar lo
comprobarse	comprobar se
comunicarnos	comunicar nos
comunicarse	comunicar se
concentrarse	concentrar se
concretarlo	concretar lo
condensarse	condensar se
conducirse	conducir se
conectarla	conectar la
conectarse	conectar se
conformándose	conformándo se
confundirse	confundir se
confundiéndose	confundiéndo se
congraciarse	congraciar se
conmemorarse	conmemorar se
conocerla	conocer la
conocerse	conocer se
conseguirlo	conseguir lo
conseguirlos	conseguir los
conservandolos	conservando los
considerarlo	considerar lo
considerarse	considerar se
considerándolas	considerán do las
constituyendose	constituyendo se
construirse	construir se
construyéndose	construyéndo se
consultarle	consultar le
consultarse	consultar se
consumirlo	consumir lo
consumirse	consumir se
contarles	contar les
contarte	contar te
contemplarlos	contemplar los
controlarlas	controlar las
controlarlos	controlar los
controlarse	controlar se
contándole	contándo le
convencerlo	convencer lo
convencerte	convencer te
convertirla	convertir la
convertirlas	convertir las
convertirlo	convertir lo
convertirlos	convertir los
convertirse	convertir se
convirtiendose	convirtiendo se
convirtiéndola	convirtiéndo la
convirtiéndolo	convirtiéndo lo
convirtiéndose	convirtiéndo se
convirténdose	convirténdo se
coronándose	coronándo se
corresponderle	corresponder le
corresponderse	corresponder se
correspondiéndola	correspondiéndo la
correspondiéndole	correspondiéndo le
cortarle	cortar le
costeándolo	costeándo lo
crearme	crear me
creyéndose	creyéndo se
creándose	creándo se
criarlo	criar lo
cuestionarle	cuestionar le
cuidarla	cuidar la
darle	dar le
darles	dar les
darme	dar me
darnos	dar nos
daros	dar os
darse	dar se
date	da te
deberse	deber se
debilitarse	debilitar se
decirle	decir le
decirles	decir les
decirlo	decir lo
decirme	decir me
deciros	decir os
decirse	decir se
declararse	declarar se
decodificarlo	decodificar lo
dedicarle	dedicar le
dedicarse	dedicar se
dedicándose	dedicándo se
definirlo	definir lo
definirse	definir se
dejarnos	dejar nos
dejarse	dejar se
dejándolos	dejándo los
dejándose	dejándo se
del	de el
demostrarle	demostrar le
demostrarnos	demostrar nos
denominarse	denominar se
denunciarlo	denunciar lo
denunciarnos	denunciar nos
depositárselo	depositár se lo
derrotarlo	derrotar lo
derrotándola	derrotándo la
desarrollarse	desarrollar se
desarrollándose	desarrollándo se
descubrilos	descubri los
desgastarse	desgastar se
deshacerse	deshacer se
desmoronarse	desmoronar se
desplazarla	desplazar la
desplazarme	desplazar me
desplazarse	desplazar se
desplazarte	desplazar te
destacarse	destacar se
destinarlas	destinar las
destituirlo	destituir lo
destruirlo	destruir lo
desvanecerse	desvanecer se
desviarse	desviar se
desvincularse	desvincular se
detenerse	detener se
deteniéndose	deteniéndo se
determinarse	determinar se
detestarlo	detestar lo
detonarla	detonar la
devolverla	devolver la
devolverle	devolver le
devolvernos	devolver nos
devolviéndolo	devolviéndo lo
diciéndole	diciéndo le
diciéndome	diciéndo me
diferenciarlo	diferenciar lo
diferenciarlos	diferenciar los
diferenciarse	diferenciar se
difundirse	difundir se
digámoslo	digám os lo
dilatarse	dilatar se
dirigirse	dirigir se
disfrazarse	disfrazar se
disfrutarlo	disfrutar lo
disfrutarse	disfrutar se
disolverse	disolver se
dispararla	disparar la
dispararle	disparar le
dispensándonos	dispensándo nos
dispersarse	dispersar se
disponiéndoselas	disponiéndo se las
disputarse	disputar se
distanciándose	distanciándo se
distinguirla	distinguir la
distinguirlo	distinguir lo
distraerla	distraer la
divertirme	divertir me
divertirse	divertir se
dividirse	dividir se
dividiéndolo	dividiéndo lo
divorciándose	divorciándo se
dormirle	dormir le
duchándonos	duchándo nos
dudarlo	dudar lo
dándola	dándo la
dándole	dándo le
dándoles	dándo les
dándome	dándo me
déjate	déja te
déjerlos	déjer los
echarle	echar le
echarnos	echar nos
echarse	echar se
educarles	educar les
educarse	educar se
ejecutarse	ejecutar se
electrocutarme	electrocutar me
elevándose	elevándo se
elimnándose	elimnándo se
embarcarse	embarcar se
emitirse	emitir se
emocionarse	emocionar se
emparejarse	emparejar se
empeorarlo	empeorar lo
empeñarse	empeñar se
empujándolas	empujándo las
enamorándose	enamorándo se
encajarse	encajar se
encontrarla	encontrar la
encontrarle	encontrar le
encontrarlo	encontrar lo
encontrarse	encontrar se
encontrándose	encontrándo se
enfocarse	enfocar se
enfrentarse	enfrentar se
engancharse	enganchar se
enorgullecerse	enorgullecer se
enquistarse	enquistar se
enseñarles	enseñar les
enseñaros	enseñar os
entenderlo	entender lo
enterarse	enterar se
enterrarlo	enterrar lo
entregarla	entregar la
entregarle	entregar le
entregarles	entregar les
entregarlos	entregar los
entregarse	entregar se
entregárselo	entregár se lo
entrevistarse	entrevistar se
enviándola	enviándo la
erigirse	erigir se
erigiéndose	erigiéndo se
escaparse	escapar se
escondiéndose	escondiéndo se
escribiéndola	escribiéndo la
escuchándolas	escuchán do las
esforzarse	esforzar se
esparcirla	esparcir la
especializándose	especializándo se
esperarse	esperar se
estafarte	estafar te
estarlo	estar lo
estimándose	estimándo se
estrangularlos	estrangular los
estrellarse	estrellar se
estrenándose	estrenándo se
estropeándose	estropeándo se
estudiarlo	estudiar lo
estudiarlos	estudiar los
evadirte	evadir te
evitarlo	evitar lo
evitarlos	evitar los
exigiéndonos	exigiéndo nos
exiliarse	exiliar se
expandirse	expandir se
expandiéndose	expandiéndo se
explicarme	explicar me
exponerse	exponer se
expulsarlos	expulsar los
extenderse	extender se
extinguiéndose	extinguiéndo se
fabricarlos	fabricar los
fabricarse	fabricar se
facilitarle	facilitar le
facilitarte	facilitar te
fastidiarlo	fastidiar lo
ficharlo	fichar lo
fijarse	fijar se
financiarse	financiar se
flanqueándolos	flanqueándo los
fotografiarse	fotografiar se
fraguándose	fraguándo se
fugarse	fugar se
fundarse	fundar se
furlo	fur lo
fusionarse	fusionar se
ganarlo	ganar lo
ganándole	ganándo le
ganándose	ganándo se
gastarse	gastar se
golpeandose	golpeando se
grabarla	grabar la
graduarse	graduar se
graduándose	graduándo se
gritandoles	gritando les
gritándole	gritándo le
guardarlos	guardar los
guardarnos	guardar nos
guiarle	guiar le
haberla	haber la
haberle	haber le
haberlo	haber lo
haberlos	haber los
haberme	haber me
haberse	haber se
haberte	haber te
habiéndonos	habiéndo nos
habiéndose	habiéndo se
hablarlo	hablar lo
hacerle	hacer le
hacerles	hacer les
hacerlo	hacer lo
hacerlos	hacer los
hacerme	hacer me
hacernos	hacer nos
haceros	hacer os
hacerse	hacer se
haciéndola	haciéndo la
haciéndolo	haciéndo lo
haciéndome	haciéndo me
haciéndose	haciéndo se
hallarse	hallar se
halándolo	halándo lo
hostigarle	hostigar le
hundirse	hundir se
ignorándola	ignorándo la
imaginarse	imaginar se
impedirles	impedir les
imponerse	imponer se
importarle	importar le
impulsarse	impulsar se
inaugurándola	inaugurándo la
inaugurándose	inaugurándo se
inciciarse	inciciar se
incluirla	incluir la
incluirse	incluir se
incluyéndose	incluyéndo se
incorporarse	incorporar se
incorporase	incorpora se
independizarla	independizar la
indiqueselo	indique se lo
infectarse	infectar se
infiltrarse	infiltrar se
informarle	informar le
informarles	informar les
informarme	informar me
iniciarse	iniciar se
iniciándose	iniciándo se
insertarse	insertar se
instalarnos	instalar nos
instalarse	instalar se
instalándose	instalándo se
integrarse	integrar se
integrándose	integrándo se
interesándose	interesándo se
interpretándose	interpretándo se
introducirse	introducir se
inventarse	inventar se
invitándola	invitándo la
invitándolos	invitándo los
invocarlo	invocar lo
irse	ir se
irte	ir te
jugarles	jugar les
jugarse	jugar se
jugarsela	jugar se la
labrarse	labrar se
lanzarse	lanzar se
lastimarlo	lastimar lo
lavarlo	lavar lo
leernos	leer nos
leerse	leer se
levantarse	levantar se
llamarme	llamar me
llamarse	llamar se
llevandoles	llevando les
llevarla	llevar la
llevarle	llevar le
llevarlo	llevar lo
llevarnos	llevar nos
llevarse	llevar se
llevarselo	llevar se lo
llevarte	llevar te
llevándose	llevándo se
lograrlo	lograr lo
lográndolos	lográndo los
mamársela	mamár se la
manejarme	manejar me
manejarse	manejar se
manifestarse	manifestar se
mantenerle	mantener le
mantenerlos	mantener los
mantenerse	mantener se
manteniéndose	manteniéndo se
marcharse	marchar se
matarlo	matar lo
matándole	matándo le
matándolos	matándo los
mejorándolo	mejorándo lo
meterme	meter me
meterse	meter se
mezclarse	mezclar se
miiverse	miiver se
moderarse	moderar se
modernizarse	modernizar se
molestarse	molestar se
montarlas	montar las
mosquearnos	mosquear nos
mostrarse	mostrar se
moverte	mover te
mudarse	mudar se
mudándose	mudándo se
necesitarse	necesitar se
negarle	negar le
negarse	negar se
negociarse	negociar se
negándose	negándo se
nombrarle	nombrar le
nótese	nó te se
obligarles	obligar les
obligándoles	obligándo les
obsequiarle	obsequiar le
observarse	observar se
obtenerla	obtener la
obteniéndose	obteniéndo se
ocuparse	ocupar se
ofrecerla	ofrecer la
ofrecerle	ofrecer le
ofreciéndole	ofreciéndo le
ofreciéndoles	ofreciéndo les
ofreciéndolo	ofreciéndo lo
olvidarlo	olvidar lo
olvidate	olvida te
oponerse	oponer se
organizarse	organizar se
otorgarle	otorgar le
otorgándoles	otorgándo les
pagarse	pagar se
paralizándose	paralizándo se
pasaros	pasar os
paseriforme	paserifor me
pasándose	pasándo se
pedirle	pedir le
pedirles	pedir les
pegaros	pegar os
pelearse	pelear se
pensarse	pensar se
percibirlas	percibir las
percibirse	percibir se
perderse	perder se
permitirle	permitir le
permitirse	permitir se
permitiéndole	permitiéndo le
permitiéndoles	permitiéndo les
perseguirme	perseguir me
persuadirlo	persuadir lo
pidiendola	pidiendo la
pidiéndole	pidiéndo le
plantarles	plantar les
plantarse	plantar se
poblarlo	poblar lo
poderse	poder se
ponerla	poner la
ponerle	poner le
ponerme	poner me
ponerse	poner se
ponerte	poner te
porlo	por lo
poseerlo	poseer lo
potabilizarlas	potabilizar las
precipitarse	precipitar se
preguntarnos	preguntar nos
preguntarse	preguntar se
pregúntate	pregúnta te
pregúntele	pregún te le
preocuparse	preocupar se
prepararlos	preparar los
prepararse	preparar se
prepárese	prepáre se
presentarse	presentar se
presentándose	presentándo se
prestándose	prestándo se
prevenirlos	prevenir los
probadlo	probad lo
probarlas	probar las
probarlo	probar lo
probárselas	probár se las
proclamándose	proclamándo se
producirla	producir la
producirse	producir se
produciéndose	produciéndo se
prolongándose	prolongándo se
pronunciarse	pronunciar se
propagarse	propagar se
proveyéndolos	proveyéndo los
pudiéndose	pudiéndo se
quedarse	quedar se
quedándole	quedándo le
quedándose	quedándo se
quemarlos	quemar los
quemarse	quemar se
quemándose	quemándo se
quitarle	quitar le
quitarles	quitar les
quitarlos	quitar los
realizarse	realizar se
realzarse	realzar se
rebajarle	rebajar le
rebajarse	rebajar se
rebelándose	rebelándo se
rechazarla	rechazar la
recibiéndolo	recibiéndo lo
reciclándolos	reciclándo los
reclamarla	reclamar la
reclutarlo	reclutar lo
recogerla	recoger la
recogerlo	recoger lo
recomendarlo	recomendar lo
reconocerle	reconocer le
reconocerse	reconocer se
reconstruirla	reconstruir la
reconvertirlo	reconvertir lo
recordarla	recordar la
recortarse	recortar se
recuperarlo	recuperar lo
recuperarse	recuperar se
reducirse	reducir se
reduzcale	reduzca le
reemplazarle	reemplazar le
reemplazarlo	reemplazar lo
reencarnandose	reencarnando se
referirse	referir se
refiriéndose	refiriéndo se
refugiarse	refugiar se
regenerarse	regenerar se
regirse	regir se
rehacerse	rehacer se
rehusarse	rehusar se
reincorporarse	reincorporar se
reiniciarlo	reiniciar lo
relajarme	relajar me
rematarlo	rematar lo
remontarse	remontar se
rendirse	rendir se
renovarlo	renovar lo
repartirse	repartir se
repatriarlo	repatriar lo
repetirlo	repetir lo
repoblarla	repoblar la
representarme	representar me
reproducirlo	reproducir lo
reproducirse	reproducir se
resaltarse	resaltar se
resguardarse	resguardar se
resguardándole	resguardándo le
resistirse	resistir se
resolverlo	resolver lo
responderme	responder me
responsabilizarse	responsabilizar se
restablecerse	restablecer se
restarle	restar le
retenerla	retener la
retenerlo	retener lo
retirarse	retirar se
retirándose	retirándo se
retrasarse	retrasar se
reunirlos	reunir los
reunirse	reunir se
revisarse	revisar se
revisándolo	revisándo lo
rivales	riva les
robándole	robándo le
rodearse	rodear se
rogarle	rogar le
romperlas	romper las
romperse	romper se
saberlo	saber lo
sacarles	sacar les
sacarlo	sacar lo
sacarme	sacar me
sacarte	sacar te
salirse	salir se
saludarle	saludar le
salvaros	salvar os
salvarse	salvar se
satisfacerlos	satisfacer los
secarse	secar se
segregarse	segregar se
seguirlos	seguir los
sentarse	sentar se
sentirse	sentir se
separarlas	separar las
separarse	separar se
serlo	ser lo
servirle	servir le
servirles	servir les
servirse	servir se
servirte	servir te
señalarlo	señalar lo
siguiéndole	siguiéndo le
sirviéndose	sirviéndo se
situarse	situar se
situándose	situándo se
socorrerlas	socorrer las
soltarlo	soltar lo
solucionarlo	solucionar lo
solucionarse	solucionar se
someterse	someter se
subirlas	subir las
subirse	subir se
subordinarse	subordinar se
sucederle	suceder le
superarla	superar la
superarlo	superar lo
suplicándole	suplicándo le
sustituírle	sustituír le
sustraerse	sustraer se
tachándolo	tachándo lo
techarlo	techar lo
tenerlo	tener lo
tenerse	tener se
tenerte	tener te
terminarlo	terminar lo
tirarlas	tirar las
tirarse	tirar se
titularse	titular se
tocándose	tocándo se
tomarlo	tomar lo
tomarnos	tomar nos
tomarse	tomar se
tomarte	tomar te
toparse	topar se
traducirse	traducir se
traerla	traer la
traerlo	traer lo
tragándose	tragándo se
transformarse	transformar se
transmitirse	transmitir se
trasformarse	trasformar se
trasladarse	trasladar se
tratandose	tratando se
tratarse	tratar se
ubicarse	ubicar se
unirse	unir se
uniéndolos	uniéndo los
usarlas	usar las
usarlos	usar los
usándose	usándo se
utilizarlo	utilizar lo
utilizarlos	utilizar los
utilizarse	utilizar se
utilizándose	utilizándo se
variarse	variar se
venderlas	vender las
venderle	vender le
venderme	vender me
venderse	vender se
vendiéndolo	vendiéndo lo
vendiéndolos	vendiéndo los
vengarle	vengar le
vengarse	vengar se
venirse	venir se
verla	ver la
verlas	ver las
verlo	ver lo
verse	ver se
visitarles	visitar les
visitarlo	visitar lo
visitarse	visitar se
viéndose	viéndo se
volverse	volver se
volviéndose	volviéndo se
véase	véa se
ábrelos	ábre los
