ao	a o
aos	a os
da	de a
dalgum	de algum
dalguma	de alguma
dalgumas	de algumas
dalguns	de alguns
dalguém	de alguém
dali	de ali
das	de as
do	de o
donde	de onde
dos	de os
doutra	de outra
doutras	de outras
doutro	de outro
doutros	de outros
dum	de um
duma	de uma
na	en a
nalgumas	em algumas
nalguns	em alguns
nas	en as
no	en o
nos	en os
noutra	em outra
noutras	em outras
noutro	em outro
noutros	em outros
num	em um
numa	em uma
pela	por a
pelas	por as
pelo	por o
pelos	por os
à	a a
às	a as
