abeirou-se	abeirou se
abraça-o	abraça o
abraça-se	abraça se
abraçá-la	abraçá la
abriram-me	abriram me
abriu-se	abriu se
abster-se	abster se
abstraindo-se	abstraindo se
acariciar-lhe	acariciar lhe
acentua-se	acentua se
acentuando-se	acentuando se
acentuar-se	acentuar se
acirrou-se	acirrou se
acode-nos	acode nos
acrescentou-lhe	acrescentou lhe
acumulam-se	acumulam se
adaptar-se	adaptar se
adequa-se	adequa se
adiantou-nos	adiantou nos
adivinha-se	adivinha se
afastou-se	afastou se
afiou-o	afiou o
afirma-o	afirma o
afirmam-se	afirmam se
agarrou-se	agarrou se
agrada-me	agrada me
agrediu-a	agrediu a
aguarda-se	aguarda se
aguentar-se	aguentar se
ajudando-os	ajudando os
aliam-se	aliam se
aliar-se	aliar se
aliou-se	aliou se
além-pirinéus	além pirinéus
amá-lo	amá lo
animam-se	animam se
antevi-me	antevi me
anti-estacionamento	anti estacionamento
anunciava-se	anunciava se
ao	a o
aos	a os
apaixonarem-se	apaixonarem se
apaixonei-me	apaixonei me
apaixonou-se	apaixonou se
apanhá-los	apanhá los
apercebeu-se	apercebeu se
aplica-se	aplica se
aponta-lhe	aponta lhe
apraz-nos	apraz nos
apreciar-se	apreciar se
apresenta-se	apresenta se
apresenta-se-	apresenta se-
apresentar-se	apresentar se
apresentaram-se	apresentaram se
apresentou-se	apresentou se
apresentá-lo	apresentá lo
apressou-se	apressou se
aprofundou-se	aprofundou se
aprova-se	aprova se
aproveitam-se	aproveitam se
aprová-lo	aprová lo
aproxima-se	aproxima se
aproximando-se	aproximando se
aproximou-se	aproximou se
apunha-lhe	apunha lhe
arranja-se	arranja se
arrastá-la	arrastá la
arrisca-se	arrisca se
arriscamo-nos	arriscamo nos
arriscar-me	arriscar me
assinale-se	assinale se
assinava-se	assinava se
assistiu-se	assistiu se
assustou-se	assustou se
atende-se	atende se
atenuar-lhes	atenuar lhes
atirando-lhe	atirando lhe
atirou-a	atirou a
atravessou-se	atravessou se
atribuindo-o	atribuindo o
atribuir-lhe	atribuir lhe
auto-excluiu-se	auto-excluiu se
autoparodiar-se	autoparodiar se
autoriza-se	autoriza se
avalia-se	avalia se
avaliam-se	avaliam se
avança-se	avança se
avistou-se	avistou se
baseia-se	baseia se
basta-nos	basta nos
bastar-se	bastar se
bater-lhe	bater lhe
bateu-me	bateu me
bateu-se	bateu se
benfica-sporting	benfica sporting
brindou-os	brindou os
calcula-se	calcula se
candidata-se	candidata se
cantou-se	cantou se
capitalizá-la	capitalizá la
centrar-se-á	centrará se
chama-se	chama se
chamam-na	chamam na
chamando-lhe	chamando lhe
chamaram-se	chamaram se
chamou-o	chamou o
chamou-se	chamou se
chateando-se	chateando se
chega-se	chega se
circulando-se	circulando se
circular-se	circular se
citam-se	citam se
citem-se	citem se
classificar-se	classificar se
classificaram-se	classificaram se
clinton-hosokawa	clinton hosokawa
coligou-se	coligou se
coloca-o	coloca o
colocam-se	colocam se
comigo	com mim
completam-se	completam se
complicar-se	complicar se
comprometeu-se	comprometeu se
compõe-se	compõe se
comunicou-lhe	comunicou lhe
conclui-a	conclui a
conclui-se	conclui se
concluir-se	concluir se
concretizar-se	concretizar se
conduzi-lo	conduzi lo
confirma-a	confirma a
confirmar-se	confirmar se
confirmarem-se	confirmarem se
confirmou-se	confirmou se
confrontando-se	confrontando se
connosco	con nosco
consagra-se	consagra se
consegue-o	consegue o
conservá-lo	conservá lo
considerando-o	considerando o
considerar-se	considerar se
consigo	com si
constata-se	constata se
conta-se	conta se
contam-se	contam se
contaram-me	contaram me
continuá-la	continuá la
contratou-o	contratou o
convencionou-se	convencionou se
convertera-se	convertera se
convidando-os	convidando os
convidou-o	convidou o
convosco	com vós
coordená-la	coordená la
cortou-lhe	cortou lhe
cotando-se	cotando se
cotar-se	cotar se
cria-se	cria se
cruzam-se	cruzam se
cumprí-la	cumprí la
curvei-me	curvei me
custa-nos	custa nos
custaram-lhe	custaram lhe
da	de a
dali	de ali
dando-lhe	dando lhe
dantes	de antes
daquela	de aquela
daquelas	de aquelas
daquele	de aquele
daqueles	de aqueles
daqui	de aqui
daquilo	de aquilo
dar-lhe	dar lhe
das	de as
daí	de aí
debate-se	debate se
debater-se	debater se
decidiu-se	decidiu se
declarar-se	declarar se
declarou-nos	declarou nos
dedicam-se	dedicam se
degradar-se	degradar se
deitou-lhe	deitou lhe
dela	de ela
delas	de elas
dele	de ele
deles	de eles
demitir-me	demitir me
demitir-se	demitir se
demitiu-se	demitiu se
depara-se	depara se
deparam-se	deparam se
depararam-se	depararam se
depenou-a	depenou a
depositava-se	depositava se
deram-se	deram se
desagradá-la	desagradá la
descem-se	descem se
descobriu-o	descobriu o
desconfiava-se	desconfiava se
desconhecendo-se	desconhecendo se
descreve-se	descreve se
descreverem-se	descreverem se
desculpe-se	desculpe se
desculpou-se	desculpou se
desenvolve-se	desenvolve se
desertificar-se	desertificar se
deslocando-se	deslocando se
deslocar-se	deslocar se
deslocarem-se	deslocarem se
deslocou-se	deslocou se
despedia-se	despedia se
dessa	de essa
dessas	de essas
desse	de esse
desses	de esses
desta	de esta
destaca-se	destaca se
destacam-se	destacam se
destaque-se	destaque se
destas	de estas
deste	de este
destes	de estes
destina-se	destina se
destinam-se	destinam se
destinava-se	destinava se
destroçá-la	destroçá la
desvalorizar-se	desvalorizar se
desviar-se	desviar se
desvincular-se	desvincular se
detectaram-se	detectaram se
deu-lhe	deu lhe
deu-me	deu me
deu-se	deu se
deve-se	deve se
dever-se	dever se
devolvendo-o	devolvendo o
dificultando-lhe	dificultando lhe
difundiram-se	difundiram se
diga-se	diga se
digo-lhe	digo lhe
dir-lhe-ia	diria lhe
dirigir-se	dirigir se
dirigiu-se	dirigiu se
disputar-se	disputar se
disse-me	disse me
disse-nos	disse nos
disse-se	disse se
disso	de isso
distancia-se	distancia se
distanciarem-se	distanciarem se
disto	de isto
distribuí-los	distribuí los
distribuíu-se	distribuíu se
divertir-nos	divertir nos
dividem-se	dividem se
dividiam-se	dividiam se
dividir-se	dividir se
dividiu-se	dividiu se
divulgá-las	divulgá las
diz-lhe	diz lhe
diz-se	diz se
dizendo-lhe	dizendo lhe
dizer-se	dizer se
dizia-se	dizia se
dizê-lo	dizê lo
do	de o
do(s)	de o(s)
dos	de os
dotá-lo	dotá lo
doutorou-se	doutorou se
dum	de um
duma	de uma
dá-lhe	dá lhe
dá-me	dá me
dá-nos	dá nos
dão-lhes	dão lhes
ei-lo	eis lo
elevou-se	elevou se
empenhar-se	empenhar se
encaminhar-se	encaminhar se
encaram-nas	encaram nas
encerram-se	encerram se
encerrou-se	encerrou se
encomendem-nos	encomendem nos
encontra-se	encontra se
encontram-se	encontram se
encontramo-nos	encontramo nos
encontraram-se	encontraram se
encontrava-se	encontrava se
encontravam-no	encontravam no
encontravam-se	encontravam se
encontrou-s	encontrou s
encontrá-la	encontrá la
enganei-me	enganei me
entrega-se	entrega se
entregam-se	entregam se
entregar-se	entregar se
envolver-se	envolver se
envolveram-se	envolveram se
esboroar-se	esboroar se
esboça-se	esboça se
escapar-se	escapar se
escreve-se	escreve se
escutar-se	escutar se
especializarem-se	especializarem se
espera-se	espera se
esperam-se	esperam se
esperando-se	esperando se
esquivou-se	esquivou se
estabelece-se	estabelece se
estabelecendo-se	estabelecendo se
estabelecer-se	estabelecer se
estendendo-a	estendendo a
estima-se	estima se
estreou-se	estreou se
evadiram-se	evadiram se
evidenciar-se	evidenciar se
ex-requiem	ex requiem
exagerou-se	exagerou se
excluindo-se	excluindo se
executá-los	executá los
exigiam-lhe	exigiam lhe
explicava-se	explicava se
fala-se	fala se
faltava-lhes	faltava lhes
faltou-lhes	faltou lhes
far-se-á	fará se
fazem-no	fazem no
fazem-se	fazem se
fazer-lhe	fazer lhe
fazer-me	fazer me
fazia-nos	fazia nos
fazia-se	fazia se
fazê-lo	fazê lo
fazê-los	fazê los
fecha-se	fecha se
fez-se	fez se
fica-se	fica se
ficar-se-á	ficará se
ficava-se	ficava se
ficou-nos	ficou nos
fixar-se	fixar se
fizeram-me	fizeram me
foi-me	foi me
foi-se	foi se
formou-se	formou se
fornecer-lhe	fornecer lhe
fundem-se	fundem se
fá-lo	fá lo
fê-lo	fê lo
ganhou-lhes	ganhou lhes
ganhá-los	ganhá los
ignora-se	ignora se
ilustrou-o	ilustrou o
impede-a	impede a
impondo-se	impondo se
imprimir-lhes	imprimir lhes
impôs-se	impôs se
impõe-se	impõe se
inalá-lo	inalá lo
inclina-se	inclina se
inclui-se	inclui se
incluiam-se	incluiam se
incluindo-se	incluindo se
incorporá-lo	incorporá lo
infectaram-nos	infectaram nos
inicia-se	inicia se
iniciar-se	iniciar se
iniciaram-se	iniciaram se
iniciou-se	iniciou se
injectar-se	injectar se
inquietam-se	inquietam se
inscrever-se	inscrever se
inscreveu-se	inscreveu se
insere-se	insere se
inspira-se	inspira se
instalar-se	instalar se
instalou-se	instalou se
institucionalizou-se	institucionalizou se
integrou-se	integrou se
inteirar-se	inteirar se
intermediaram-se	intermediaram se
interroga-se	interroga se
interrogar-nos	interrogar nos
interrompê-la	interrompê la
intrometer-se	intrometer se
inverte-se	inverte se
ir-se	ir se
irritou-se	irritou se
isolou-se	isolou se
jogá-los	jogá los
juntar-se	juntar se
juntar-se-ão	juntarão se
juntarão-se-	juntarão se-
juntem-se	juntem se
juntou-se	juntou se
justifica-se	justifica se
lançar-se	lançar se
lançou-se	lançou se
lançá-la	lançá la
leia-se	leia se
lembra-se	lembra se
lembrando-lhe	lembrando lhe
lembrando-se	lembrando se
lembrou-se	lembrou se
leu-se	leu se
leva-os	leva os
levando-o	levando o
levantar-se	levantar se
levantaram-se	levantaram se
levar-me	levar me
levaram-me	levaram me
levou-o	levou o
levá-las	levá las
lha	lhe a
libertar-se	libertar se
lidou-se	lidou se
limita-se	limita se
limitam-se	limitam se
limitou-se	limitou se
livrarmo-nos	livrarmo nos
localizá-lo	localizá lo
lê-se	lê se
mandá-las	mandá las
manifestam-se	manifestam se
manifestando-se	manifestando se
manifestar-se	manifestar se
manifestaram-se	manifestaram se
manipularam-se	manipularam se
manter-los	manter los
manter-se	manter se
manteve-se	manteve se
mantivemo-nos	mantivemo nos
mantém-se	mantém se
mantê-lo	mantê lo
mantê-los	mantê los
matá-la	matá la
medi-lo	medi lo
mostra-se	mostra se
mostrando-se	mostrando se
mostrar-nos	mostrar nos
mostrar-se	mostrar se
mostrou-se	mostrou se
mover-se	mover se
movimentaram-se	movimentaram se
na	em a
nacionalizá-lo	nacionalizá lo
nalgumas	em algumas
nalguns	em alguns
naquela	em aquela
naquele	em aquele
naqueles	em aqueles
naquilo	em aquilo
nas	em as
negocia-se	negocia se
nela	em ela
nelas	em elas
nele	em ele
neles	em eles
nessa	em essa
nessas	em essas
nesse	em esse
nesses	em esses
nesta	em esta
nestas	em estas
neste	em este
nestes	em estes
nisso	em isso
nisto	em isto
no	em o
nomeá-lo	nomeá lo
nos	em os
noticiava-se	noticiava se
noutra	em outra
noutras	em outras
noutro	em outro
noutros	em outros
num	em um
numa	em uma
numas	em umas
obrigando-os	obrigando os
obtém-se	obtém se
ocupava-se	ocupava se
oferecendo-lhe	oferecendo lhe
opondo-se	opondo se
opor-se	opor se
optou-se	optou se
orgulhar-se	orgulhar se
ouviu-se	ouviu se
paralisá-la	paralisá la
parece-me	parece me
parecer-me-ia	pareceria me
parte-se	parte se
passa-se	passa se
passeou-se	passeou se
passou-se	passou se
pedia-se	pedia se
pediram-me	pediram me
pela	por a
pelas	por as
pelo	por o
pelos	por os
pensa-se	pensa se
pensar-se	pensar se
pense-se	pense se
percebe-se	percebe se
perdeu-se	perdeu se
perfilam-se	perfilam se
pergunta-lhe	pergunta lhe
perguntou-lhe	perguntou lhe
permitir-lhe	permitir lhe
permitir-lhe-ia	permitiria lhe
permitiram-lhe	permitiram lhe
peço-lhes	peço lhes
pode-se	pode se
poder-se-á	poderá se
portar-se	portar se
portava-se	portava se
posiciona-se	posiciona se
pra	para a
prefaciou-o	prefaciou o
prejudica-me	prejudica me
prende-se	prende se
preocupar-se	preocupar se
preparar-se	preparar se
prepare-se	prepare se
prestou-as	prestou as
presume-se	presume se
prevendo-se	prevendo se
proceder-se-á	procederá se
processar-se-á	processará se
procurar-se	procurar se
produzí-lo	produzí lo
pronunciar-se	pronunciar se
pronunciou-se	pronunciou se
proporcionar-lhe	proporcionar lhe
propunham-se	propunham se
propõe-se	propõe se
propõem-nos	propõem nos
propõem-se	propõem se
provocou-me	provocou me
pôde-se	pôde se
queixa-se	queixa se
queixam-se	queixam se
queixou-se	queixou se
rasgou-lhe	rasgou lhe
reacender-se	reacender se
realiza-se	realiza se
realizar-se	realizar se
realizaram-se	realizaram se
rebelar-se	rebelar se
recandidatar-se	recandidatar se
recomenda-se	recomenda se
reconhecendo-se	reconhecendo se
reconheceu-me	reconheceu me
recordar-lhe	recordar lhe
recorde-se	recorde se
recordou-lhe	recordou lhe
recorrendo-se	recorrendo se
recriando-se	recriando se
recriminam-se	recriminam se
recusando-se	recusando se
redimiu-se	redimiu se
reencontrou-se	reencontrou se
refere-se	refere se
referem-se	referem se
referia-se	referia se
referindo-se	referindo se
referir-se	referir se
refugio-me	refugio me
refugiou-se	refugiou se
registar-se	registar se
registe-se	registe se
registou-se	registou se
regozija-se	regozija se
regozijou-se	regozijou se
reintegrá-lo	reintegrá lo
relaciona-se	relaciona se
relatar-lhe	relatar lhe
render-se	render se
repartir-se	repartir se
repetem-se	repetem se
resolvê-la	resolvê la
respirou-se	respirou se
responde-nos	responde nos
respondem-lhes	respondem lhes
respondem-me	respondem me
respondeu-me	respondeu me
retirar-nos	retirar nos
reunir-se	reunir se
reuniram-se	reuniram se
reuniu-se	reuniu se
revela-se	revela se
revelar-se	revelar se
revelaram-se	revelaram se
revelou-se	revelou se
revestir-se	revestir se
revê-la	revê la
revê-se	revê se
reúne-se	reúne se
reúnem-se	reúnem se
riem-se	riem se
rodeaste-te	rodeaste te
roubar-lhe	roubar lhe
roubá-la	roubá la
sabe-se	sabe se
sabendo-se	sabendo se
segue-se	segue se
seguiam-na	seguiam na
seguindo-se	seguindo se
seguir-se	seguir se
seguir-se-ia	seguiria se
seguiram-se	seguiram se
seguiu-se	seguiu se
seja-se	seja se
sendo-se	sendo se
senta-se	senta se
sentar-se	sentar se
sentaram-se	sentaram se
separaram-se	separaram se
ser-se	ser se
serve-nos	serve nos
serve-se	serve se
servindo-se	servindo se
serviu-se	serviu se
simplificam-se	simplificam se
sinto-me	sinto me
situa-se	situa se
situando-se	situando se
situar-se	situar se
sobem-se	sobem se
sofrem-nas	sofrem nas
sofrê-la	sofrê la
somando-se	somando se
sossegou-me	sossegou me
subiram-lhe	subiram lhe
submeter-se	submeter se
substitui-lo	substitui lo
substituí-lo	substituí lo
sucedem-se	sucedem se
suicidar-se	suicidar se
suicidou-se	suicidou se
suscitam-me	suscitam me
sustenta-se	sustenta se
sustêm-se	sustêm se
tapou-lhe	tapou lhe
telefonaram-me	telefonaram me
tem-se	tem se
tendo-lhe	tendo lhe
tendo-se	tendo se
tenta-se	tenta se
ter-se	ter se
tinha-se	tinha se
tinham-se	tinham se
tirava-as	tirava as
tome-se	tome se
torna-se	torna se
tornando-as	tornando as
tornando-se	tornando se
tornar-se	tornar se
tornara-se	tornara se
tornaram-se	tornaram se
tornou-se	tornou se
torná-la	torná la
torná-la-ia	tornaria la
torná-lo	torná lo
trabalha-se	trabalha se
traduziram-se	traduziram se
traduziu-o	traduziu o
trair-vos	trair vos
transaccionava-se	transaccionava se
transformar-se	transformar se
trata-se	trata se
tratando-se	tratando se
tratar-se	tratar se
tratar-se-á	tratará se
tratava-se	tratava se
tratavam-se	tratavam se
treiná-lo	treiná lo
trocando-o	trocando o
trocando-os	trocando os
trouxe-o	trouxe o
tê-la	tê la
tê-lo	tê lo
unia-se	unia se
usou-o	usou o
vaciná-la	vaciná la
valença-monção	valença monção
valorizando-a	valorizando a
valorizar-se	valorizar se
valorizou-se	valorizou se
vejam-se	vejam se
vende-las	vende las
vendem-se	vendem se
venderam-se	venderam se
ver-se-á	verá se
ver-se-é	verá se
verifica-se	verifica se
verificar-se	verificar se
verificou-se	verificou se
via-se	via se
viam-se	viam se
visitá-la	visitá la
vou-me	vou me
vê-se	vê se
à	a a
àquela	a aquela
àquele	a aquele
àqueles	a aqueles
às	a as
é-o	é o
