ehkei	ehk ei
ellei	ell ei
elleivät	ell eivät
ellen	ell en
ellet	ell et
ellette	ell ette
ettei	ett ei
etteikö	ett eikö
etteivät	ett eivät
etteivätkö	ett eivätkö
etten	ett en
ettenkö	ett enkö
ettet	ett et
ettette	ett ette
jollei	joll ei
jolleivat	joll eivat
jolleivät	joll eivät
jollen	joll en
jollet	joll et
jossei	joss ei
jottei	jott ei
jotten	jott en
miksei	miks ei
mikseipä	miks eipä
mikset	miks et
muttei	mutt ei
mutteipa	mutt eipa
vaikkei	vaikk ei
vaikkeivät	vaikk eivät
vaikken	vaikk en
vaikket	vaikk et
