آبائنا	آبائنا آبائنا
آراءها	آراء ها
آرائهم	آراء هم
آرائهن	آراء هن
آلياتها	آليات ها
آمالنا	آمالنا آمالنا
أبحاثهم	أبحاث هم
أبرزها	أبرز ها
أبرمه	أبرم ه
أبلغنا	أبلغ نا
أبوابها	أبواب ها
أبيه	أبي ه
أبيهم	أبي هم
أثارتها	أثارت ها
أثره	أثر ه
أثمانها	أثمان ها
أجاء	أ جاء
أجازتها	إجازة ها
أجراها	أجرى ها
أجراهما	أجرى هما
أجرته	أجرت ه
أجلها	أجل ها
أحاطه	أحاط ه
أحدها	أحد ها
أحدهم	أحد هم
أحزابها	أحزاب ها
أحزابهم	أحزاب هم
أحوالهم	أحوال هم
أخالفها	أخالفها أخالفها
أخبرها	أخبر ها
أذاعته	أذاعت ه
أذاعه	أذاع ه
أراضيها	أراضي ها
أرباحه	أرباح ه
أرجعه	أرجع ه
أرساها	أرسى ها
أرسله	أرسل ه
أرصدتها	أرصدة ها
أرضها	أرض ها
أرفقته	أرفقت ه
أركانها	أركان ها
أزرهم	أزر هم
أزمته	أزمة ه
أزمتها	أزمة ها
أساسه	أساس ه
أسبابها	أسباب ها
أسسها	أسس ها
أسعارها	أسعار ها
أسعارهما	أسعارهما أسعارهما
أسفها	أسف ها
أسلافه	أسلاف ه
أسلحتها	أسلحة ها
أسمائهن	أسماء هن
أسمته	أسمت ه
أسنانك	أسنان ك
أسهمها	أسهم ها
أشهرها	أشهر ها
أصابه	أصاب ه
أصحابها	أصحاب ها
أصدرتها	أصدرت ها
أصدره	أصدر ه
أصدرها	أصدر ها
أصدقاءه	أصدقاء ه
أصدقائك	أصدقاء ك
أصدقه	أصدقه أصدقه
أصـــدقاءهــــا	أصـــدقاءهــــا أصـــدقاءهــــا
أصوله	أصول ه
أصولها	أصول ها
أطلقه	أطلق ه
أطلقها	أطلق ها
أعاده	أعاد ه
أعدته	أعدت ه
أعدتها	أعدت ها
أعده	أعد ه
أعدها	أعد ها
أعدّه	أعد ه
أعضائه	أعضاء ه
أعضائها	أعضاء ها
أعلنته	أعلنت ه
أعلنه	أعلن ه
أعلنها	أعلن ها
أعمارهن	أعمار هن
أعمالك	أعمال ك
أعماله	أعمال ه
أعمالها	أعمال ها
أعمالهم	أعمال هم
أغلبها	أغلب ها
أغلبهم	أغلب هم
أفراده	أفراد ه
أفكارك	أفكار ك
أفكاره	أفكار ه
أقاربك	أقارب ك
أقامته	أقامت ه
أقامتها	أقامت ها
أقامها	أقام ها
أقدامهم	أقدام هم
أقرتها	أقرت ها
أقرها	أقر ها
أقساطه	أقساط ه
أقصاها	أقصى ها
أكان	أ كان
أكانت	أ كانت
أكده	أكد ه
أكدها	أكد ها
ألا	أن لا
ألغاها	ألغى ها
ألفاظه	ألفاظه ألفاظه
ألفها	ألف ها
ألقاها	ألقى ها
أمامك	أمام ك
أمامنا	أمامنا أمامنا
أمامه	أمام ه
أمامها	أمام ها
أمامهما	أمامهما أمامهما
أمرهم	أمر هم
أمضاها	أمضى ها
أملاكهم	أملاك هم
أمله	أمل ه
أملها	أمل ها
أمننا	أمننا أمننا
أمنها	أمن ها
أمواله	أموال ه
أموالها	أموال ها
أموالهم	أموال هم
أمورك	أمور ك
أنشأته	أنشأت ه
أنشأتها	أنشأت ها
أنشطتهما	أنشطتهما أنشطتهما
أنفسنا	أنفس نا
أنفسهم	أنفس هم
أنقلك	أنقلك أنقلك
أنك	أن ك
أننا	أننا أننا
أنه	أن ه
أنها	أن ها
أنهم	أن هم
أنهما	أنهما أنهما
أنواعها	أنواع ها
أهدافها	أهداف ها
أهدافهم	أهداف هم
أهداهم	أهدى هم
أهله	أهل ه
أهلهم	أهلهم أهلهم
أهلهن	أهل هن
أهمها	أهم ها
أهميتها	أهمية ها
أهميــتها	أهمية ها
أوجه	أوج ه
أوضاعهم	أوضاع هم
أوطاننا	أوطاننا أوطاننا
أولادك	أولاد ك
أولهما	أول هما
أولوياتك	أولويات ك
أولوياتها	أولويات ها
أوليائهم	أولياء هم
أيامك	أيام ك
أيديهم	أيديهم أيديهم
إبرازها	إبراز ها
إبرامها	إبرام ها
إتباعها	اتباع ها
إتمامها	إتمام ها
إجراءاتهم	إجراءات هم
إجراؤها	إجراء ها
إجماليه	إجمالي ه
إجماليها	إجمالي ها
إحداهما	إحدى هما
إحساسك	إحساس ك
إخطارهم	إخطار هم
إدارته	إدارة ه
إدانته	إدانة ه
إرجاءه	إرجاء ه
إرهاقك	إرهاق ك
إسلامه	إسلام ه
إسمه	اسم ه
إصابته	إصابة ه
إصابتهم	إصابة هم
إصابتهما	إصابة هما
إصداراته	إصدارات ه
إصدارها	إصدار ها
إصرارها	إصرار ها
إصلاحها	إصلاح ها
إطلاقه	إطلاق ه
إطلاقها	إطلاق ها
إعجابه	إعجاب ه
إعلانه	إعلان ه
إفطارها	إفطار ها
إفلاسها	إفلاس ها
إقالته	إقالة ه
إقامته	إقامة ه
إقامتها	إقامة ها
إقراره	إقرار ه
إقراضها	إقراض ها
إلحاقهم	إلحاق هم
إلغاؤه	إلغاء ه
إلغاؤها	إلغاء ها
إلغائها	إلغاء ها
إلقائه	إلقاء ه
إلينا	إلينا إلينا
إليه	إلي ه
إليها	إلي ها
إليهم	إلي هم
إليهن	إلي هن
إمكاناتها	إمكانات ها
إنتاجه	إنتاج ه
إنتاجها	إنتاج ها
إنشاءه	إنشاء ه
إنشاؤها	إنشاء ها
إنفاقك	إنفاق ك
إنفاقها	إنفاق ها
إنك	إن ك
إننا	إن نا
إنني	إنني إنني
إنه	إن ه
إنها	إن ها
إنهم	إن هم
إنهن	إن هن
إياه	إيا ه
إياها	إيا ها
إيراداتها	إيرادات ها
إيماءته	إيماءته إيماءته
إيمانه	إيمان ه
إيمانها	إيمان ها
اباؤهم	اباؤهم اباؤهم
ابتعاده	ابتعاده ابتعاده
ابحاثهم	أبحاث هم
ابديناها	ابديناها ابديناها
ابرزها	أبرز ها
ابرزهم	أبرز هم
ابرزهما	أبرز هما
ابعادها	ابعادها ابعادها
ابقائه	إبقاء ه
ابلغتنا	ابلغتنا ابلغتنا
ابلغنا	ابلغنا ابلغنا
ابلغه	أبلغ ه
ابلغوه	أبلغوا ه
ابناؤه	ابناؤه ابناؤه
ابنائه	ابنائه ابنائه
ابنته	ابنة ه
ابنتها	ابنة ها
ابنه	ابن ه
ابوابها	أبواب ها
اتباعه	اتباع ه
اتباعها	اتباع ها
اتجاهها	اتجاه ها
اتجاههم	اتجاه هم
اتخاذها	اتخاذ ها
اتخذته	اتخذت ه
اتخذتها	اتخذت ها
اتخذه	اتخذ ه
اتصالهما	اتصال هما
اتفاقهم	اتفاق هم
اتهامه	اتهام ه
اتهامهم	اتهام هم
اثارتها	أثارت ها
اثاره	أثار ه
اجازاتهم	إجازات هم
اجازته	إجازة ه
اجبارهم	اجبارهم اجبارهم
اجتاحه	اجتاح ه
اجتماعاتها	اجتماعات ها
اجتماعه	اجتماع ه
اجتماعها	اجتماع ها
اجتماعهما	اجتماعهما اجتماعهما
اجتياحه	اجتياح ه
اجرائها	إجراء ها
اجراها	أجرى ها
اجرته	أجرت ه
اجرتها	أجرت ها
اجلاءهم	إجلاء هم
اجماليه	إجمالي ه
اجوائها	أجواء ها
احالتها	إحالة ها
احالتهم	إحالة هم
احترامي	احترامي احترامي
احتفالاته	احتفالاته احتفالاته
احتلاله	احتلال ه
احتلتها	احتلت ها
احتياجاتنا	احتياجات نا
احتياجاته	احتياجات ه
احتياجاتها	احتياجات ها
احتياجاتهم	احتياجات هم
احتياطاتها	احتياطات ها
احداثها	إحداث ها
احدهم	أحد هم
احدهما	احدهما احدهما
احراجها	أحراج ها
احضرها	أحضر ها
احكامه	أحكام ه
احكامها	أحكام ها
احياؤها	إحياء ها
اختاره	اختار ه
اختارها	اختار ها
اختياره	اختيار ه
اخدموه	اخدموا ه
اخذه	اخذه اخذه
اخماده	إخماد ه
اخواننا	اخواننا اخواننا
ادائنا	ادائنا ادائنا
ادائها	أداء ها
ادائي	أداء ي
ادارته	إدارة ه
ادارتها	إدارة ها
ادانتها	ادانتها ادانتها
ادخاله	إدخال ه
ادخالهم	إدخال هم
ادراكها	ادراكها ادراكها
اذاعه	أذاع ه
اذيالهم	أذيال هم
ارائهم	آراء هم
اراضيه	أراضي ه
اراضيها	أراضي ها
ارتباطه	ارتباط ه
ارتباطها	ارتباط ها
ارتفاعه	ارتفاع ه
ارتفاعها	ارتفاع ها
ارتكابها	ارتكاب ها
ارتكبتها	ارتكبت ها
ارتكبها	ارتكب ها
ارثها	إرث ها
ارسالهم	ارسالهم ارسالهم
ارضه	أرض ه
ارضها	أرض ها
ارهابه	ارهابه ارهابه
ازدرائه	ازدراء ه
ازمته	أزمة ه
اسألني	اسألني اسألني
اسبابها	أسباب ها
استبداله	استبدال ه
استبعادهم	استبعاد هم
استثماراته	استثمارات ه
استثماراتها	استثمارات ها
استثماره	استثمار ه
استثمارها	استثمار ها
استجوبوه	استجوبوا ه
استخدامه	استخدام ه
استخدامها	استخدام ها
استخدمته	استخدمت ه
استخراجها	استخراج ها
استدعاؤهم	استدعاؤهم استدعاؤهم
استردادها	استرداد ها
استسلامنا	استسلامنا استسلامنا
استضافته	استضافت ه
استطاعتنا	استطاعتنا استطاعتنا
استعادتها	استعادتها استعادتها
استعداده	استعداد ه
استعدادها	استعداد ها
استعرضها	استعرض ها
استغراقها	استغراقها استغراقها
استـــغلوها	استغلوا ها
استقالاتهم	استقالات هم
استقالته	استقالة ه
استقالتهم	استقالة هم
استقباله	استقبال ه
استقبلني	استقبلني استقبلني
استقبله	استقبل ه
استقبلوه	استقبلوا ه
استقراره	استقرار ه
استقرارها	استقرار ها
استمرارها	استمرار ها
استمرارهم	استمرار هم
استهدفه	استهدف ه
استهلاكها	استهلاك ها
استيائها	استياء ها
استيائهم	استياء هم
استيراده	استيراد ه
استيرادها	استيراد ها
استيفائهم	استيفاء هم
استيلائه	استيلاء ه
اسراهما	اسراهما اسراهما
اسرتهم	أسرة هم
اسسه	أسس ه
اسطولنا	اسطولنا اسطولنا
اسطولها	أسطول ها
اسعاره	أسعار ه
اسعارها	أسعار ها
اسقاطه	اسقاطه اسقاطه
اسقاطها	إسقاط ها
اسقطته	أسقطت ه
اسماؤهم	أسماء هم
اسمه	اسم ه
اسمها	اسم ها
اسمي	اسمي اسمي
اسميهما	اسميهما اسميهما
اسنانها	أسنان ها
اشرافه	إشراف ه
اشقائنا	اشقائنا اشقائنا
اصاباتهم	اصاباتهم اصاباتهم
اصابته	إصابة ه
اصابتها	إصابة ها
اصحابها	أصحاب ها
اصدرته	أصدرت ه
اصدرتها	أصدرت ها
اصدره	أصدر ه
اصدقاؤنا	اصدقاؤنا اصدقاؤنا
اصدقائنا	اصدقائنا اصدقائنا
اصطحبني	اصطحبني اصطحبني
اصطدامها	اصطدام ها
اضطرنا	اضطرنا اضطرنا
اضمحلالها	اضمحلالها اضمحلالها
اطفائها	إطفاء ها
اطلاقها	إطلاق ها
اطلاقهم	إطلاق هم
اطلعه	أطلع ه
اطلقها	أطلق ها
اعادتها	إعادة ها
اعاره	أعار ه
اعتباره	اعتبار ه
اعتبارها	اعتبار ها
اعتبره	اعتبر ه
اعتبرها	اعتبر ها
اعتزاله	اعتزال ه
اعتزامها	اعتزام ها
اعتقاده	اعتقاد ه
اعتقلتهم	اعتقلت هم
اعتقله	اعتقل ه
اعتمدتها	اعتمدت ها
اعتمدها	اعتمد ها
اعدتها	أعدت ها
اعرافنا	اعرافنا اعرافنا
اعضائه	أعضاء ه
اعطاءنا	اعطاءنا اعطاءنا
اعقبته	أعقبت ه
اعلانه	اعلانه اعلانه
اعلانها	اعلانها اعلانها
اعلنته	أعلنت ه
اعلنه	أعلن ه
اعلنها	أعلن ها
اعمارهم	أعمار هم
اعماله	أعمال ه
اعمالها	أعمال ها
اعمالهم	أعمال هم
اغلاقها	إغلاق ها
افادته	إفادة ه
افتتاحه	افتتاح ه
افتتاحها	افتتاح ها
افتراءاتهم	افتراءات هم
افرزه	أفرز ه
افسادها	إفساد ها
اقاربهم	اقاربهم اقاربهم
اقامته	إقامة ه
اقامتها	أقامت ها
اقامتي	اقامتي اقامتي
اقتراحنا	اقتراحنا اقتراحنا
اقتراضها	اقتراض ها
اقترحته	اقترحت ه
اقترحتها	اقترحت ها
اقترحها	اقترح ها
اقترفتها	اقترفت ها
اقتصادنا	اقتصادنا اقتصادنا
اقتصادياتهما	اقتصادياتهما اقتصادياتهما
اقتصارها	اقتصار ها
اقتطاعه	اقتطاع ه
اقتطاعها	اقتطاع ها
اقتناعاته	اقتناعاته اقتناعاته
اقدامنا	إقدام نا
اقراره	إقرار ه
اقصاه	أقصى ه
اقطابها	أقطاب ها
اقلاعها	إقلاع ها
اقلها	أقل ها
اكتسبوها	اكتسبوا ها
اكتشافه	اكتشاف ه
اكثرهم	اكثرهم اكثرهم
اكرره	اكرره اكرره
الا	أن لا
الامنا	الامنا الامنا
التحامها	التحام ها
التزاماتنا	التزاماتنا التزاماتنا
التزاماته	التزامات ه
التزاماتهم	التزامات هم
التزامه	التزام ه
التزامها	التزام ها
التزامهم	التزام هم
التزامهما	التزامهما التزامهما
التقيناهم	التقيناهم التقيناهم
التهمته	التهمت ه
الشهر	الشهر الماضي
الصادر	الصادر عن
الغاؤها	إلغاء ها
الغائها	إلغاء ها
القاه	ألقى ه
القاها	ألقى ها
القتها	ألقت ها
الوزير	الوزير الأمريكي
اليكم	إلي كم
الينا	الينا الينا
اليه	إلي ه
اليها	إلي ها
اليهم	إلي هم
اليهما	اليهما اليهما
اليّ	الي الي
امالها	آمال ها
امامنا	امامنا امامنا
امامها	أمام ها
امامهم	أمام هم
امامي	امامي امامي
امبراطوريته	إمبراطورية ه
امتعتهم	أمتعة هم
امكانها	إمكان ها
امكانهم	إمكان هم
امله	أمل ه
امننا	امننا امننا
امنهم	أمن هم
امينه	أمين ه
انتاجها	إنتاج ها
انتخابه	انتخاب ه
انتخابها	انتخاب ها
انتخابهم	انتخاب هم
انتظرته	انتظرت ه
انتقالية	انتقالية ل إدارة
انتماءاتهم	انتماءات هم
انتهائها	انتهاء ها
انتهاكاتها	انتهاكات ها
انجزها	أنجز ها
انحرافهم	انحراف هم
انزالها	إنزال ها
انزعاجه	انزعاجه انزعاجه
انشاؤها	إنشاء ها
انشطتهم	انشطتهم انشطتهم
انضمامها	انضمام ها
انطلاقها	انطلاق ها
انفتاحه	انفتاح ه
انفسنا	انفسنا انفسنا
انفسهم	أنفس هم
اننا	إن نا
انني	إن ني
انه	إن ه
انها	أن ها
انهم	أن هم
انهما	انهما انهما
انهياره	انهيار ه
انواعها	أنواع ها
اني	اني اني
اهتماماته	اهتمامات ه
اهتمامنا	اهتمامنا اهتمامنا
اهتمامه	اهتمام ه
اهتمامها	اهتمام ها
اهلهم	أهل هم
اهمها	أهم ها
اهميتها	أهمية ها
اوانها	اوانها اوانها
اوردتها	أوردت ها
اوصافها	أوصاف ها
اولاها	أولى ها
اولها	أول ها
اولوياته	اولوياته اولوياته
اولوياتها	أولويات ها
ايار	أيار /
اياها	إيا ها
اياهم	إيا هم
اياهما	اياهما اياهما
ايديكم	أيدي كم
ايديها	أيدي ها
ايقافها	إيقاف ها
ايقافهم	إيقاف هم
بآل	ب آل
بآلاف	ب آلاف
بآلية	ب آلية
بآيات	ب آيات
بأبتكار	ب ابتكار
بأبعاد	ب أبعاد
بأجهزة	ب أجهزة
بأجور	ب أجور
بأحد	ب أحد
بأحدث	ب أحدث
بأحزمة	ب أحزمة
بأحواز	ب أحواز
بأخبارها	ب أخبار ها
بأخذ	بأخذ بأخذ
بأخرى	ب أخرى
بأخوة	ب أخوة
بأدوية	بأدوية بأدوية
بأراضيها	ب أراضي ها
بأرض	ب أرض
بأزمة	ب أزمة
بأسرع	ب أسرع
بأسرها	ب أسر ها
بأسعار	ب أسعار
بأسلوب	ب أسلوب
بأسيوط	بأسيوط بأسيوط
بأشخاص	ب أشخاص
بأصناف	ب أصناف
بأعداد	ب أعداد
بأعضاء	ب أعضاء
بأعضائه	ب أعضاء ه
بأعمال	ب أعمال
بأفراد	ب أفراد
بأفريقيا	ب أفريقيا
بأقدام	ب أقدام
بأقصى	ب أقصى
بأقل	ب أقل
بأكثر	ب أكثر
بأكملها	ب أكمل ها
بألا	ب أن لا
بأمثلة	ب أمثلة
بأمراض	ب أمراض
بأمريكا	ب أمريكا
بأمننا	بأمننا بأمننا بأمننا
بأموال	ب أموال
بأمور	ب أمور
بأن	ب أن
بأنفسنا	بأنفسنا بأنفسنا بأنفسنا
بأنفسهم	ب أنفس هم
بأننا	بأننا بأننا بأننا
بأنه	ب أن ه
بأنها	ب أن ها
بأنهم	ب أن هم
بأنهما	بأنهما بأنهما بأنهما
بأهمية	ب أهمية
بأوراق	ب أوراق
بأوصاف	ب أوصاف
بأوضاع	ب أوضاع
بأول	ب أول
بأي	ب أي
بأيام	ب أيام
بأيدي	بأيدي بأيدي
بؤسها	بؤس ها
بإبادة	ب إبادة
بإثارة	ب إثارة
بإجراء	ب إجراء
بإجمالي	ب إجمالي
بإحد	ب أحد
بإحدى	ب إحدى
بإحلال	ب إحلال
بإحياء	ب إحياء
بإدارة	ب إدارة
بإدراج	ب إدراج
بإذعانها	ب إذعان ها
بإرادتهم	ب إرادة هم
بإرسال	ب إرسال
بإزالة	ب إزالة
بإسرائيل	ب إسرائيل
بإسقاط	ب إسقاط
بإسلامه	ب إسلام ه
بإشراف	ب إشراف
بإشراك	ب إشراك
بإشهاره	ب إشهار ه
بإصدار	ب إصدار
بإصدارها	ب إصدار ها
بإصلاح	ب إصلاح
بإضافة	ب إضافة
بإطلاق	ب إطلاق
بإعادة	ب إعادة
بإعداد	ب إعداد
بإعطاء	ب إعطاء
بإعطائه	ب إعطاء ه
بإعفاء	ب إعفاء
بإعلان	ب إعلان
بإقالة	ب إقالة
بإقامة	ب إقامة
بإقبال	ب إقبال
بإقرار	ب إقرار
بإلحاد	ب إلحاد
بإلحاق	ب إلحاق
بإلغاء	ب إلغاء
بإلغائه	ب إلغاء ه
بإمكان	ب إمكان
بإمكانات	ب إمكانات
بإنتاج	ب إنتاج
بإنشاء	ب إنشاء
بإنهاء	بإنهاء بإنهاء
بائتلاف	ب ائتلاف
بابراز	ب إبراز
بابعاده	ب إبعاد ه
بابها	باب ها
بابو	بابو بابو
بابي	بابي بابي
باتجاه	ب اتجاه
باتجاهه	ب اتجاه ه
باتحاد	ب اتحاد
باتخاذ	ب اتخاذ
باتفاق	ب اتفاق
باتفاقيات	ب اتفاقيات
باتفاقية	ب اتفاقية
باجتذاب	ب اجتذاب
باجتماع	ب اجتماع
باجتياح	ب اجتياح
باجراء	ب إجراء
باجراءات	ب إجراءات
باجماع	باجماع باجماع
باحترام	باحترام باحترام
باحتلال	ب احتلال
باحتمالات	ب احتمالات
باحتياجات	ب احتياجات
باحلال	ب إحلال
باحواز	ب أحواز
باختبار	ب اختبار
باختراع	ب اختراع
باختصار	ب اختصار
باختلاف	ب اختلاف
باختيار	ب اختيار
باختياره	ب اختيار ه
باخر	ب آخر
بادارة	ب إدارة
بادخار	ب ادخار
بادمان	ب إدمان
بارائنا	ب آراء نا
بارتباطات	ب ارتباطات
بارتفاع	ب ارتفاع
بارتياح	ب ارتياح
بارسال	ب إرسال
بازاء	ب إزاء
باستئناف	ب استئناف
باستبعاد	ب استبعاد
باستبعادها	ب استبعاد ها
باستثمارات	ب استثمارات
باستثماراتك	ب استثمارات ك
باستثناء	ب استثناء
باستجابتها	ب استجابة ها
باستجواب	ب استجواب
باستحداث	ب استحداث
باستخدام	ب استخدام
باستدعائه	ب استدعاء ه
باسترداد	ب استرداد
باستصدار	ب استصدار
باستعادة	ب استعادة
باستفاضة	ب استفاضة
باستفحال	ب استفحال
باستقالته	ب استقالة ه
باستقبال	ب استقبال
باستقدام	ب استقدام
باستقلال	ب استقلال
باستكمال	ب استكمال
باستمرار	ب استمرار
باستهداف	ب استهداف
باستيراد	ب استيراد
باستيعاب	ب استيعاب
باسرائيل	باسرائيل باسرائيل
باسرع	باسرع باسرع
باسره	باسره باسره
باسقاط	باسقاط باسقاط
باسم	ب اسم
باسماء	ب أسماء
باسمك	ب اسم ك
باسمه	ب اسم ه
باشتراك	ب اشتراك
باشراف	ب إشراف
باشراكها	ب إشراك ها
باشرطة	ب أشرطة
باشرها	باشر ها
باشعال	ب إشعال
باشغال	ب أشغال
باشهار	ب إشهار
باشهر	ب أشهر
باضرار	ب أضرار
باضعاف	باضعاف باضعاف
باطفاء	ب إطفاء
باطلاق	ب إطلاق
باعادة	ب إعادة
باعتبار	ب اعتبار
باعتباره	ب اعتبار ه
باعتبارها	ب اعتبار ها
باعتبارهم	ب اعتبار هم
باعتبارهما	ب اعتبار هما
باعتراض	ب اعتراض
باعتزاز	باعتزاز باعتزاز
باعتماد	ب اعتماد
باعجوبة	باعجوبة باعجوبة
باعداد	ب إعداد
باعراض	باعراض باعراض
باعصار	ب إعصار
باعقاب	ب أعقاب
باعلان	ب إعلان
باعمال	ب أعمال
باعمالهم	ب أعمال هم
باغتته	باغتت ه
باغتيال	ب اغتيال
باغلاق	ب إغلاق
بافراغ	بافراغ بافراغ
بافضل	ب أفضل
بافلام	ب أفلام
باقامة	ب إقامة
باقتناء	ب اقتناء
باقرار	ب إقرار
بالآتي	ب الآتي
بالآخرين	ب الآخرين
بالأجنبي	ب الأجنبي
بالأذى	ب الأذى
بالأراضي	ب الأراضي
بالأردن	ب الأردن
بالأرض	ب الأرض
بالأساس	ب الأساس
بالأسعار	ب الأسعار
بالأسمنت	ب الأسمنت
بالأسواق	ب الأسواق
بالأصناف	ب الأصناف
بالأضافة	ب الإضافة
بالأطفال	ب الأطفال
بالأفلام	ب الأفلام
بالأقصر	ب الأقصر
بالأكراد	ب الأكراد
بالأكياس	ب الأكياس
بالأمان	ب الأمان
بالأمن	ب الأمن
بالأنشطة	ب الأنشطة
بالأهرام	ب الأهرام
بالأوراق	ب الأوراق
بالإجرام	ب الإجرام
بالإجماع	ب الإجماع
بالإخلال	ب الإخلال
بالإسراع	ب الإسراع
بالإسكندرية	ب الإسكندرية
بالإسلام	ب الإسلام
بالإسلاميين	ب الإسلاميين
بالإسماعيلية	ب الإسماعيلية
بالإشارة	ب الإشارة
بالإشراف	ب الإشراف
بالإصلاح	ب الإصلاح
بالإصلاحات	ب الإصلاحات
بالإضافة	ب الإضافة
بالإعداد	ب الإعداد
بالإغراق	ب الإغراق
بالإغلاق	ب الإغلاق
بالإمكان	ب الإمكان
بالإنتاج	ب الإنتاج
بالابداعات	ب الإبداعات
بالابر	ب الإبر
بالاتجار	ب الاتجار
بالاتحاد	ب الاتحاد
بالاتصالات	ب الاتصالات
بالاتفاق	ب الاتفاق
بالاتفاقيات	ب الاتفاقيات
بالاثر	ب الأثر
بالاحتفاظ	ب الاحتفاظ
بالاحتلال	ب الاحتلال
بالاحتياجات	ب الاحتياجات
بالاحتياطي	ب الاحتياطي
بالاحداث	ب الأحداث
بالاختلاف	ب الاختلاف
بالاختيار	ب الاختيار
بالاخلاقية	ب الأخلاقية
بالادارة	ب الإدارة
بالارهاب	ب الإرهاب
بالازمة	ب الأزمة
بالاساس	ب الأساس
بالاستثمار	ب الاستثمار
بالاستثمارات	ب الاستثمارات
بالاستجابة	ب الاستجابة
بالاستحقاق	ب الاستحقاق
بالاستخدام	ب الاستخدام
بالاستعانة	ب الاستعانة
بالاستفادة	ب الاستفادة
بالاستناد	ب الاستناد
بالاسطول	ب الأسطول
بالاسهاب	ب الإسهاب
بالاشتراك	ب الاشتراك
بالاشعة	ب الأشعة
بالاصلاحات	ب الإصلاحات
بالاضافة	ب الإضافة
بالاطفال	ب الأطفال
بالاعتداء	ب الاعتداء
بالاعتماد	ب الاعتماد
بالاعدام	ب الإعدام
بالاعلان	ب الإعلان
بالافراج	ب الإفراج
بالافكار	ب الأفكار
بالافلاس	ب الإفلاس
بالاقبال	ب الإقبال
بالالتحام	ب الالتحام
بالالتزام	ب الالتزام
بالالتزامات	ب الالتزامات
بالالتهاب	ب الالتهاب
بالالوان	ب الألوان
بالامانة	ب الأمانة
بالامتناع	ب الامتناع
بالامر	ب الأمر
بالامكان	ب الإمكان
بالانتحارية	ب الانتحارية
بالانتخاب	ب الانتخاب
بالانتقال	ب الانتقال
بالانتقام	ب الانتقام
بالانتماء	ب الانتماء
بالانخفاض	ب الانخفاض
بالاندية	ب الأندية
بالانسحاب	ب الانسحاب
بالانضمام	ب الانضمام
بالانفتاح	ب الانفتاح
بالانفلونزا	ب الإنفلونزا
بالاوكسجين	ب الأوكسجين
بالايجاب	ب الإيجاب
بالايدي	ب الأيدي
بالبحث	ب البحث
بالبحيرة	ب البحيرة
بالبر	ب البر
بالبرازيل	ب البرازيل
بالبرتغالية	ب البرتغالية
بالبرلمان	ب البرلمان
بالبرونز	ب البرونز
بالبريد	ب البريد
بالبشر	ب البشر
بالبضائع	ب البضائع
بالبقاء	ب البقاء
بالبلاد	ب البلاد
بالبنتاجون	بالبنتاجون بالبنتاجون
بالبنتاغون	ب البنتاغون
بالبنك	ب البنك
بالبنوك	ب البنوك
بالبنية	ب البنية
بالبورصات	ب البورصات
بالبيان	ب البيان
بالتأكيد	ب التأكيد
بالتأمين	ب التأمين
بالتاخر	ب التأخر
بالتاكيد	ب التأكيد
بالتالي	ب التالي
بالتبلد	ب التبلد
بالتجارة	ب التجارة
بالتحدث	ب التحدث
بالتحديد	ب التحديد
بالتحريض	ب التحريض
بالتحصيل	ب التحصيل
بالتحفظ	ب التحفظ
بالتحقيق	ب التحقيق
بالتدخل	ب التدخل
بالتدريس	ب التدريس
بالترتيب	ب الترتيب
بالترحيب	ب الترحيب
بالتركيز	ب التركيز
بالترميم	ب الترميم
بالترويج	ب الترويج
بالتزاماتنا	بالتزاماتنا بالتزاماتنا بالتزاماتنا
بالتزاماتها	ب التزامات ها
بالتزاماتهما	بالتزاماتهما بالتزاماتهما بالتزاماتهما
بالتزامن	ب التزامن
بالتزايد	ب التزايد
بالتسلط	ب التسلط
بالتشجيع	ب التشجيع
بالتصدير	ب التصدير
بالتصريح	ب التصريح
بالتصريحات	ب التصريحات
بالتصعيد	ب التصعيد
بالتضامن	ب التضامن
بالتطلعات	ب التطلعات
بالتظاهر	ب التظاهر
بالتعادل	ب التعادل
بالتعامل	ب التعامل
بالتعاون	ب التعاون
بالتعبير	ب التعبير
بالتعديلات	ب التعديلات
بالتعريفات	ب التعريفات
بالتعريفة	ب التعريفة
بالتعلم	ب التعلم
بالتعليقات	ب التعليقات
بالتعليم	ب التعليم
بالتعويض	ب التعويض
بالتغلغل	ب التغلغل
بالتغييرات	ب التغييرات
بالتفاصيل	ب التفاصيل
بالتفاوض	ب التفاوض
بالتفتيش	ب التفتيش
بالتفريط	ب التفريط
بالتفصيل	ب التفصيل
بالتفكير	ب التفكير
بالتفوق	ب التفوق
بالتقصير	ب التقصير
بالتكنولوجيا	ب التكنولوجيا
بالتلميح	ب التلميح
بالتماس	ب التماس
بالتمام	ب التمام
بالتمريض	ب التمريض
بالتمويل	ب التمويل
بالتنسيق	ب التنسيق
بالتنقل	ب التنقل
بالتنوع	ب التنوع
بالتهديد	ب التهديد
بالتهميش	ب التهميش
بالتواطؤ	ب التواطؤ
بالتوجه	ب التوجه
بالتوقعات	ب التوقعات
بالتوقف	ب التوقف
بالتوقيت	ب التوقيت
بالتيار	ب التيار
بالثقافة	ب الثقافة
بالثوابت	ب الثوابت
بالجامعة	ب الجامعة
بالجرائم	ب الجرائم
بالجريمة	ب الجريمة
بالجزء	ب الجزء
بالجزائر	ب الجزائر
بالجمالية	ب الجمالية
بالجمعية	ب الجمعية
بالجميع	ب الجميع
بالجناح	ب الجناح
بالجنة	ب الجنة
بالجنسية	ب الجنسية
بالجنوب	ب الجنوب
بالجنيه	ب الجنيه
بالجهتين	ب الجهتين
بالجهد	ب الجهد
بالجهل	ب الجهل
بالجهود	ب الجهود
بالجوامع	ب الجوامع
بالجيزة	ب الجيزة
بالحادث	ب الحادث
بالحاكم	ب الحاكم
بالحبل	ب الحبل
بالحجارة	ب الحجارة
بالحد	ب الحد
بالحدث	ب الحدث
بالحدود	ب الحدود
بالحذر	ب الحذر
بالحرب	ب الحرب
بالحرس	ب الحرس
بالحزب	ب الحزب
بالحساب	ب الحساب
بالحضور	ب الحضور
بالحق	ب الحق
بالحكومات	ب الحكومات
بالحكومة	ب الحكومة
بالحلم	ب الحلم
بالحماية	ب الحماية
بالحوار	ب الحوار
بالحياة	ب الحياة
بالخارج	ب الخارج
بالخارجية	ب الخارجية
بالخبراء	ب الخبراء
بالخدمات	ب الخدمات
بالخطأ	ب الخطإ
بالخطط	ب الخطط
بالخطوط	ب الخطوط
بالخلع	ب الخلع
بالخليج	ب الخليج
بالخيار	ب الخيار
بالخيانة	ب الخيانة
بالخير	ب الخير
بالخيل	ب الخيل
بالدخول	ب الدخول
بالدعاء	ب الدعاء
بالدعم	ب الدعم
بالدعوة	ب الدعوة
بالدفاع	ب الدفاع
بالدقة	ب الدقة
بالدم	ب الدم
بالدماء	ب الدماء
بالدورة	ب الدورة
بالدول	ب الدول
بالدولار	ب الدولار
بالدولة	ب الدولة
بالديموقراطية	ب الديموقراطية
بالدينار	ب الدينار
بالديون	ب الديون
بالذات	ب الذات
بالذكر	ب الذكر
بالرأي	ب الرأي
بالرؤية	ب الرؤية
بالرئيس	ب الرئيس
بالرائد	ب الرائد
بالراحة	ب الراحة
بالربع	ب الربع
بالرخاء	ب الرخاء
بالرخصة	ب الرخصة
بالرصاص	ب الرصاص
بالرغم	ب الرغم
بالرفض	ب الرفض
بالرقابة	ب الرقابة
بالرقم	ب الرقم
بالرهان	ب الرهان
بالرياض	ب الرياض
بالزرقاوي	بالزرقاوي بالزرقاوي
بالزيارة	ب الزيارة
بالسابق	ب السابق
بالسارس	ب السارس
بالسبب	ب السبب
بالسجن	ب السجن
بالسعادة	ب السعادة
بالسعودية	ب السعودية
بالسعي	ب السعي
بالسفارة	ب السفارة
بالسفر	ب السفر
بالسلاح	ب السلاح
بالسلام	ب السلام
بالسلب	ب السلب
بالسلطة	ب السلطة
بالسلع	ب السلع
بالسماح	ب السماح
بالسهولة	ب السهولة
بالسودان	ب السودان
بالسوق	ب السوق
بالسيئ	ب السيئ
بالسيئة	ب السيئة
بالسيادة	ب السيادة
بالشؤون	ب الشؤون
بالشجاعة	ب الشجاعة
بالشحن	ب الشحن
بالشخص	ب الشخص
بالشرعية	ب الشرعية
بالشرق	ب الشرق
بالشركات	ب الشركات
بالشركة	ب الشركة
بالشركتين	ب الشركتين
بالشروط	ب الشروط
بالشكل	ب الشكل
بالشلل	ب الشلل
بالشمال	ب الشمال
بالشهادتين	ب الشهادتين
بالصادرات	ب الصادرات
بالصحابة	ب الصحابة
بالصحة	ب الصحة
بالصحراء	ب الصحراء
بالصحف	ب الصحف
بالصف	ب الصف
بالصفقة	ب الصفقة
بالصمت	ب الصمت
بالصناعة	ب الصناعة
بالصهيونية	ب الصهيونية
بالصواريخ	ب الصواريخ
بالصيغة	ب الصيغة
بالصين	ب الصين
بالضبط	ب الضبط
بالضبطية	ب الضبطية
بالضجة	ب الضجة
بالضرورة	ب الضرورة
بالضعف	ب الضعف
بالضفة	ب الضفة
بالضلوع	ب الضلوع
بالضمانات	ب الضمانات
بالطائرات	ب الطائرات
بالطائرة	ب الطائرة
بالطابع	ب الطابع
بالطاقة	ب الطاقة
بالطب	ب الطب
بالطبع	ب الطبع
بالطريقة	ب الطريقة
بالطلب	ب الطلب
بالطوب	ب الطوب
بالظروف	ب الظروف
بالعائد	ب العائد
بالعاصمة	ب العاصمة
بالعالم	ب العالم
بالعام	ب العام
بالعاملين	ب العاملين
بالعبور	ب العبور
بالعجز	ب العجز
بالعدل	ب العدل
بالعدوان	ب العدوان
بالعذاب	ب العذاب
بالعراق	ب العراق
بالعقارات	ب العقارات
بالعلاقات	ب العلاقات
بالعلوم	ب العلوم
بالعمل	ب العمل
بالعملة	ب العملة
بالعمومية	ب العمومية
بالعنف	ب العنف
بالعودة	ب العودة
بالعيد	ب العيد
بالعين	ب العين
بالغائه	ب إلغاء ه
بالغائها	ب إلغاء ها
بالغاز	ب الغاز
بالغالبية	ب الغالبية
بالغرق	ب الغرق
بالغواصة	ب الغواصة
بالفائدة	ب الفائدة
بالفاشل	ب الفاشل
بالفترة	ب الفترة
بالفحص	ب الفحص
بالفرار	ب الفرار
بالفرنسية	ب الفرنسية
بالفساد	ب الفساد
بالفشل	ب الفشل
بالفعل	ب الفعل
بالفلسطينيين	ب الفلسطينيين
بالفلوجة	ب الفلوجة
بالفيدرالية	ب الفيدرالية
بالفيروسات	ب الفيروسات
بالقائمين	ب القائمين
بالقارة	ب القارة
بالقاعات	ب القاعات
بالقاعدة	ب القاعدة
بالقانون	ب القانون
بالقاهرة	ب القاهرة
بالقبارصة	ب القبارصة
بالقتل	ب القتل
بالقدر	ب القدر
بالقدس	ب القدس
بالقذائف	ب القذائف
بالقذافي	ب القذافي
بالقرار	ب القرار
بالقرب	ب القرب
بالقرض	ب القرض
بالقروض	ب القروض
بالقسم	ب القسم
بالقضاء	ب القضاء
بالقضية	ب القضية
بالقطاع	ب القطاع
بالقطاعات	ب القطاعات
بالقفز	ب القفز
بالقلبين	ب القلبين
بالقلق	ب القلق
بالقنابل	ب القنابل
بالقنصلية	ب القنصلية
بالقوات	ب القوات
بالقوانين	ب القوانين
بالقوة	ب القوة
بالقول	ب القول
بالقيروان	ب القيروان
بالقيم	ب القيم
بالكأس	ب الكأس
بالكارثة	ب الكارثة
بالكامل	ب الكامل
بالكاميرا	ب الكاميرا
بالكتاب	ب الكتاب
بالكثير	ب الكثير
بالكرة	ب الكرة
بالكرم	ب الكرم
بالكفاءة	ب الكفاءة
بالكفر	ب الكفر
بالكلام	ب الكلام
بالكميات	ب الكميات
بالكنيسة	ب الكنيسة
بالكهرباء	ب الكهرباء
بالكويت	ب الكويت
باللائمة	ب اللائمة
باللجنة	ب اللجنة
باللجوء	ب اللجوء
باللياقة	ب اللياقة
بالليونة	ب الليونة
بالمؤتمر	ب المؤتمر
بالمئة	ب المئة
بالمائة	ب المائة
بالماس	ب الماس
بالمبادرات	ب المبادرات
بالمبادرة	ب المبادرة
بالمبنى	ب المبنى
بالمبيدات	ب المبيدات
بالمتخصصين	ب المتخصصين
بالمثل	ب المثل
بالمثلث	ب المثلث
بالمجالات	ب المجالات
بالمجان	ب المجان
بالمجر	ب المجر
بالمجلس	ب المجلس
بالمجموعة	ب المجموعة
بالمخاوف	ب المخاوف
بالمختبرات	ب المختبرات
بالمخدرات	ب المخدرات
بالمدارس	ب المدارس
بالمدة	ب المدة
بالمدن	ب المدن
بالمدينة	ب المدينة
بالمراجعة	ب المراجعة
بالمراسلة	ب المراسلة
بالمرافق	ب المرافق
بالمراكز	ب المراكز
بالمرحلة	ب المرحلة
بالمرشح	ب المرشح
بالمرض	ب المرض
بالمرضى	ب المرضى
بالمركز	ب المركز
بالمزاعم	ب المزاعم
بالمزيد	ب المزيد
بالمسؤولية	ب المسؤولية
بالمساعدة	ب المساعدة
بالمساعي	ب المساعي
بالمساواة	ب المساواة
بالمستثمرين	ب المستثمرين
بالمستشفى	ب المستشفى
بالمستوى	ب المستوى
بالمسجد	ب المسجد
بالمسنين	ب المسنين
بالمسودة	ب المسودة
بالمسيح	ب المسيح
بالمشاركة	ب المشاركة
بالمشروع	ب المشروع
بالمشــاركة	ب المشاركة
بالمصادقة	ب المصادقة
بالمصطلحات	ب المصطلحات
بالمطهرات	ب المطهرات
بالمعالم	ب المعالم
بالمعدات	ب المعدات
بالمعنى	ب المعنى
بالمعهد	ب المعهد
بالمفاجآت	ب المفاجآت
بالمقابل	ب المقابل
بالمقارنة	ب المقارنة
بالمكاتب	ب المكاتب
بالمكتب	ب المكتب
بالمكتبة	ب المكتبة
بالملابس	ب الملابس
بالملايين	ب الملايين
بالمماطلة	ب المماطلة
بالمناخ	ب المناخ
بالمناسبة	ب المناسبة
بالمناطق	ب المناطق
بالمنتجات	ب المنتجات
بالمنتخب	ب المنتخب
بالمنستير	بالمنستير بالمنستير
بالمنشآت	ب المنشآت
بالمنطقة	ب المنطقة
بالمهام	ب المهام
بالمهمات	ب المهمات
بالموارد	ب الموارد
بالمواطنين	ب المواطنين
بالمواعيد	ب المواعيد
بالموافقة	ب الموافقة
بالمواقف	ب المواقف
بالموضة	ب الموضة
بالموعد	ب الموعد
بالمولد	ب المولد
بالمياه	ب المياه
بالنار	ب النار
بالنتائج	ب النتائج
بالنجاح	ب النجاح
بالنسبة	ب النسبة
بالنشاط	ب النشاط
بالنضال	ب النضال
بالنظام	ب النظام
بالنظر	ب النظر
بالنفط	ب النفط
بالنفع	ب النفع
بالنقاط	ب النقاط
بالنقب	ب النقب
بالنقد	ب النقد
بالنقل	ب النقل
بالنيابة	ب النيابة
باله	بال ه
بالهدف	ب الهدف
بالهراوات	ب الهراوات
بالهزء	ب الهزء
بالهليكوبتر	بالهليكوبتر بالهليكوبتر
بالهند	ب الهند
بالهوية	ب الهوية
بالهيئة	ب الهيئة
بالهيمنة	ب الهيمنة
بالوجود	ب الوجود
بالورود	ب الورود
بالوزارة	ب الوزارة
بالوسائل	ب الوسائل
بالوضع	ب الوضع
بالوطن	ب الوطن
بالوقائع	ب الوقائع
بالوقت	ب الوقت
بالوقف	ب الوقف
بالوقود	ب الوقود
بالوقوف	ب الوقوف
بالوكالة	ب الوكالة
بالولايات	ب الولايات
بالولاية	ب الولاية
باليابان	ب اليابان
باليمن	ب اليمن
باليهود	ب اليهود
باليورو	ب اليورو
باليوم	ب اليوم
بام	ب أم
بامكان	بامكان بامكان
بامكانات	ب إمكانات
بامكانه	ب إمكان ه
بامكانهم	ب إمكان هم
بامير	ب أمير
بان	ب أن
باناس	ب أناس
بانتاج	ب إنتاج
بانتحار	ب انتحار
بانتخاب	ب انتخاب
بانتشار	ب انتشار
بانتظام	ب انتظام
بانتعاش	ب انتعاش
بانتقادات	ب انتقادات
بانتمائه	ب انتماء ه
بانتهاء	ب انتهاء
بانجاز	ب إنجاز
بانجازاته	ب إنجازات ه
بانحناء	ب انحناء
بانخفاض	ب انخفاض
بانزعاج	ب انزعاج
بانسحاب	ب انسحاب
بانشاء	ب إنشاء
بانضمام	ب انضمام
بانعقاد	ب انعقاد
بانفجار	ب انفجار
بانفراج	ب انفراج
بانفسنا	ب أنفس نا
بانقاذ	ب إنقاذ
بانقلاب	ب انقلاب
باننا	ب أن نا
بانني	ب أن ني
بانه	ب أن ه
بانها	ب أن ها
بانهاء	ب إنهاء
بانهم	ب أن هم
بانواع	ب أنواع
باهتمام	ب اهتمام
باهتمامها	ب اهتمام ها
باهداف	باهداف باهداف
باوامر	ب أوامر
باوضاع	ب أوضاع
باول	ب أول
باى	ب أي
باي	ب أي
بايدى	بايدى بايدى
بايعاز	ب إيعاز
بايوائها	ب إيواء ها
بباب	ب باب
ببحث	ببحث ببحث
ببدء	ب بدء
ببراءة	ب براءة
ببرامج	ب برامج
ببرقيات	ب برقيات
ببرنامج	ب برنامج
ببريطانيا	ب بريطانيا
ببشرتك	ب بشرة ك
ببطء	ب بطء
ببطولة	ب بطولة
ببعض	ب بعض
ببعضها	ب بعض ها
ببغداد	ب بغداد
ببقاء	ب بقاء
ببكين	ب بكين
ببلورة	ب بلورة
ببناء	ب بناء
ببنك	ب بنك
ببنود	ب بنود
ببورتو	ب بورتو
ببيان	ب بيان
ببيع	ب بيع
بتأجيل	ب تأجيل
بتأسيس	ب تأسيس
بتأسيسه	ب تأسيس ه
بتأميمها	ب تأميم ها
بتأمينها	ب تأمين ها
بتأييد	ب تأييد
بتاريخ	ب تاريخ
بتبنى	ب تبني
بتبييض	ب تبييض
بتتبع	ب تتبع
بتثبيت	ب تثبيت
بتجارة	ب تجارة
بتجاهله	ب تجاهل ه
بتجاوزات	ب تجاوزات
بتجديد	ب تجديد
بتجميد	ب تجميد
بتحديث	ب تحديث
بتحديد	ب تحديد
بتحرير	ب تحرير
بتحريض	ب تحريض
بتحريك	ب تحريك
بتحريكه	ب تحريك ه
بتحريم	ب تحريم
بتحسين	ب تحسين
بتحصيل	ب تحصيل
بتحصيلها	ب تحصيل ها
بتحـــقيق	ب تحقيق
بتحقيق	ب تحقيق
بتحقيقه	ب تحقيق ه
بتحليل	ب تحليل
بتحويل	ب تحويل
بتخريب	ب تخريب
بتخزين	ب تخزين
بتخصيص	ب تخصيص
بتخفيض	ب تخفيض
بتخفيف	بتخفيف بتخفيف
بتدخل	ب تدخل
بتدريس	ب تدريس
بتدعيم	ب تدعيم
بتدفق	ب تدفق
بتراثه	ب تراث ه
بترتيب	ب ترتيب
بترجمة	ب ترجمة
بترحيل	ب ترحيل
بترشح	ب ترشح
بترك	ب ترك
بتركيا	ب تركيا
بتركيع	ب تركيع
بترولها	بترول ها
بتزايد	ب تزايد
بتزويد	ب تزويد
بتسع	ب تسع
بتسعة	ب تسعة
بتسلم	ب تسلم
بتسليم	ب تسليم
بتسهيل	ب تسهيل
بتسهيلات	ب تسهيلات
بتسوية	بتسوية بتسوية
بتشجيع	ب تشجيع
بتشكيل	ب تشكيل
بتشكيله	ب تشكيل ه
بتصدير	ب تصدير
بتصريح	بتصريح بتصريح
بتصريحات	ب تصريحات
بتصريحه	ب تصريح ه
بتصفية	ب تصفية
بتصنيف	ب تصنيف
بتصور	بتصور بتصور
بتصوير	ب تصوير
بتطبيق	ب تطبيق
بتطور	ب تطور
بتطورات	ب تطورات
بتطوير	ب تطوير
بتطويق	ب تطويق
بتعازيهم	ب تعازي هم
بتعاون	ب تعاون
بتعبئة	ب تعبئة
بتعرض	ب تعرض
بتعريف	ب تعريف
بتعزيز	ب تعزيز
بتعطيل	ب تعطيل
بتعقب	بتعقب بتعقب
بتعليق	ب تعليق
بتعميم	ب تعميم
بتعهداتهم	ب تعهدات هم
بتعويض	ب تعويض
بتعويضات	بتعويضات بتعويضات
بتعويم	ب تعويم
بتعيين	ب تعيين
بتغطية	ب تغطية
بتغيير	ب تغيير
بتـــسليمها	ب تسليم ها
بتفاؤله	ب تفاؤل ه
بتفاقم	ب تفاقم
بتفتيش	ب تفتيش
بتفجيرات	بتفجيرات بتفجيرات
بتفسير	ب تفسير
بتفسيرهم	ب تفسير هم
بتفعيل	ب تفعيل
بتفقد	ب تفقد
بتقدمه	ب تقدم ه
بتقدير	ب تقدير
بتقديم	ب تقديم
بتقرير	ب تقرير
بتقسيم	ب تقسيم
بتكاليف	بتكاليف بتكاليف
بتكتم	ب تكتم
بتكفير	ب تكفير
بتكفيره	ب تكفير ه
بتكلفة	ب تكلفة
بتكليف	ب تكليف
بتكنولوجيا	ب تكنولوجيا
بتل	ب تل
بتلاوة	ب تلاوة
بتلبية	ب تلبية
بتلقي	بتلقي بتلقي
بتلك	ب تلك
بتمهيد	ب تمهيد
بتمويل	ب تمويل
بتمويلها	ب تمويل ها
بتميز	ب تميز
بتناقضات	بتناقضات بتناقضات
بتنسيق	ب تنسيق
بتنظيف	ب تنظيف
بتنظيم	ب تنظيم
بتنـــفيذ	ب تنفيذ
بتنفيذ	ب تنفيذ
بتنفيذه	ب تنفيذ ه
بتنفيذها	ب تنفيذ ها
بتنوع	ب تنوع
بتهريب	ب تهريب
بتهم	ب تهم
بتهمة	ب تهمة
بتوازن	ب توازن
بتوافق	ب توافق
بتوثيق	بتوثيق بتوثيق
بتوجيه	ب توجيه
بتوجيهات	ب توجيهات
بتوخي	ب توخي
بتوريد	ب توريد
بتوزيع	ب توزيع
بتوسع	ب توسع
بتوسيع	ب توسيع
بتوصية	ب توصية
بتوطيد	ب توطيد
بتوفير	ب توفير
بتوقع	ب توقع
بتوقف	ب توقف
بتوقيت	ب توقيت
بتوقيع	ب توقيع
بتونس	بتونس بتونس
بتيسيرات	ب تيسيرات
بثمانية	ب ثمانية
بثمن	ب ثمن
بثه	بث ه
بثها	بث ها
بثوابتها	ب ثوابت ها
بثّته	بثت ه
بجائزتي	ب جائزتي
بجامعة	ب جامعة
بجانب	ب جانب
بجدار	ب جدار
بجدة	ب جدة
بجدول	بجدول بجدول
بجدية	ب جدية
بجديد	ب جديد
بجرأة	بجرأة بجرأة
بجرائم	ب جرائم
بجراح	ب جراح
بجروح	ب جروح
بجروحه	ب جروح ه
بجريمة	ب جريمة
بجلاء	ب جلاء
بجلسة	ب جلسة
بجماعة	بجماعة بجماعة
بجمع	ب جمع
بجمعها	ب جمع ها
بجمعية	ب جمعية
بجمهورية	ب جمهورية
بجميع	ب جميع
بجنوب	ب جنوب
بجهاز	ب جهاز
بجهة	ب جهة
بجهود	ب جهود
بجوازات	ب جوازات
بجودة	ب جودة
بجولة	ب جولة
بجولته	ب جولة ه
بحائط	ب حائط
بحاجة	ب حاجة
بحال	ب حال
بحالة	ب حالة
بحب	ب حب
بحبل	بحبل بحبل
بحثه	بحث ه
بحجب	ب حجب
بحجة	ب حجة
بحجم	ب حجم
بحد	ب حد
بحدة	بحدة بحدة
بحدوث	ب حدوث
بحديث	ب حديث
بحذر	ب حذر
بحرارة	ب حرارة
بحراستها	ب حراسة ها
بحرف	ب حرف
بحروق	ب حروق
بحرية	ب حرية
بحس	ب حس
بحساب	ب حساب
بحسب	ب حسب
بحصار	بحصار بحصار
بحصر	بحصر بحصر
بحصول	ب حصول
بحصوله	ب حصول ه
بحضور	ب حضور
بحظر	ب حظر
بحفريات	ب حفريات
بحق	ب حق
بحقها	ب حق ها
بحقيقة	ب حقيقة
بحكم	ب حكم
بحكومة	ب حكومة
بحل	ب حل
بحلها	ب حل ها
بحلوان	ب حلوان
بحلول	ب حلول
بحلوله	ب حلول ه
بحملة	ب حملة
بحمى	ب حمى
بحوالى	ب حوالي
بحوالي	ب حوالي
بحوزة	ب حوزة
بحوزته	ب حوزة ه
بحياة	ب حياة
بحيازتهم	ب حيازة هم
بحيث	ب حيث
بحيوانات	بحيوانات بحيوانات
بخبر	بخبر بخبر
بخبراء	ب خبراء
بخبرات	ب خبرات
بخبرة	ب خبرة
بخدمات	ب خدمات
بخدمته	ب خدمة ه
بخروج	ب خروج
بخريطة	ب خريطة
بخزان	ب خزان
بخصوص	ب خصوص
بخطة	ب خطة
بخطر	ب خطر
بخطفه	ب خطف ه
بخطوات	ب خطوات
بخطوط	بخطوط بخطوط
بخفض	ب خفض
بخلاف	ب خلاف
بخليج	ب خليج
بخيارات	ب خيارات
بخيبة	ب خيبة
بخير	ب خير
بدأناه	بدأناه بدأناه
بدأه	بدأ ه
بدأها	بدأ ها
بداياته	بداياته بداياته
بداياتها	بداياتها بداياتها
بدايته	بداية ه
بدبابات	ب دبابات
بدخول	ب دخول
بدراسة	ب دراسة
بدراسته	ب دراسة ه
بدرجة	ب درجة
بدرس	ب درس
بدعتهم	بدعتهم بدعتهم
بدعم	ب دعم
بدعمها	ب دعم ها
بدعوة	ب دعوة
بدعوى	ب دعوى
بدفء	ب دفء
بدفع	ب دفع
بدفعة	ب دفعة
بدقة	ب دقة
بدليل	ب دليل
بدمنهور	ب دمنهور
بدور	ب دور
بدوران	ب دوران
بدوره	ب دور ه
بدورها	ب دور ها
بدول	ب دول
بدولة	ب دولة
بدون	ب دون
بدين	بدين بدين
بديناميكية	ب ديناميكية
بذات	ب ذات
بذكاء	بذكاء بذكاء
بذلتها	بذلت ها
بذلـــك	ب ذٰلك
بذلك	ب ذٰلك
بذلها	بذل ها
بذلوه	بذلوا ه
بر	بر الصين
برأس	ب رأس
برأسمال	ب رأسمال
برأسمالها	ب رأسمال ها
برؤوس	ب رؤوس
برئاسة	ب رئاسة
برئيس	ب رئيس
براءتها	براءة ها
براءتهم	براءة هم
براءتي	براءة ي
براحة	ب راحة
برامجه	برامج ه
برامجها	برامجها برامجها
برتب	ب رتب
برحيل	ب رحيل
برحيلهم	ب رحيل هم
برد	ب رد
بردود	ب ردود
برسائل	ب رسائل
برسالة	ب رسالة
برسم	ب رسم
برسوم	ب رسوم
برصاص	ب رصاص
برصيد	ب رصيد
برضا	ب رضا
برضى	ب رضى
برعاية	ب رعاية
برغم	ب رغم
برفض	ب رفض
برفع	ب رفع
برفقة	ب رفقة
برقم	ب رقم
برمته	ب رمة ه
برمتها	ب رمة ها
برنامجنا	برنامجنا برنامجنا
برنامجه	برنامج ه
برنامجها	برنامج ها
برواتب	ب رواتب
بروح	بروح بروح
برياح	برياح برياح
بزته	بزة ه
بزراعة	ب زراعة
بزعامة	ب زعامة
بزعم	ب زعم
بزمن	ب زمن
بزيادة	ب زيادة
بزيادتها	ب زيادة ها
بزيارات	ب زيارات
بزيارة	ب زيارة
بسؤاله	ب سؤال ه
بسامراء	ب سامراء
بسب	ب سب
بسبب	ب سبب
بسبعة	ب سبعة
بسبـــــب	ب سبب
بسجن	ب سجن
بسحب	ب سحب
بسحبه	ب سحب ه
بسداد	ب سداد
بسرعة	ب سرعة
بسريلانكا	ب سريلانكا
بسعة	ب سعة
بسعر	ب سعر
بسفينة	ب سفينة
بسلاحها	ب سلاح ها
بسلامة	بسلامة بسلامة
بسلسلة	ب سلسلة
بسلطاتها	ب سلطات ها
بسلع	ب سلع
بسليمان	بسليمان بسليمان
بسمعة	ب سمعة
بسن	ب سن
بسهل	ب سهل
بسهولة	ب سهولة
بسوء	ب سوء
بسوريا	ب سوريا
بسوق	ب سوق
بسيارته	ب سيارة ه
بسياسة	ب سياسة
بسيــــــــارات	ب سيارات
بسيناريو	بسيناريو بسيناريو
بسيّاح	بسياح بسياح
بشأن	ب شأن
بشأنها	ب شأن ها
بشأنهما	ب شأن هما
بشئون	ب شؤون
بشاب	بشاب بشاب
بشار	بشار الأسد
بشارون	ب شارون
بشان	ب شأن
بشانغهاى	ب شانغهاي
بشباب	ب شباب
بشبكة	ب شبكة
بشجاعة	بشجاعة بشجاعة
بشخص	ب شخص
بشد	ب شد
بشدة	ب شدة
بشراء	ب شراء
بشرط	ب شرط
بشرق	ب شرق
بشركات	ب شركات
بشركة	ب شركة
بشركتي	ب شركتي
بشروطهم	ب شروط هم
بشري	بشري بشري
بشريحة	ب شريحة
بشظية	ب شظية
بشعارات	ب شعارات
بشعبة	ب شعبة
بشفافية	ب شفافية
بشكل	ب شكل
بشكوى	بشكوى بشكوى
بشمال	ب شمال
بشموليته	ب شمولية ه
بشن	ب شن
بشهر	ب شهر
بشهرة	ب شهرة
بشيء	ب شيء
بصاحبات	ب صاحبات
بصادرات	ب صادرات
بصبر	بصبر بصبر
بصحة	ب صحة
بصحراء	ب صحراء
بصحيفة	ب صحيفة
بصداقة	بصداقة بصداقة
بصدد	ب صدد
بصراحة	ب صراحة
بصراع	ب صراع
بصرف	ب صرف
بصريح	ب صريح
بصعوبة	ب صعوبة
بصفاقس	ب صفاقس
بصفة	ب صفة
بصفتنا	بصفتنا بصفتنا بصفتنا
بصفته	ب صفة ه
بصفتها	ب صفة ها
بصوت	ب صوت
بصور	ب صور
بصورة	ب صورة
بضبط	ب ضبط
بضرب	ب ضرب
بضرورة	ب ضرورة
بضعاف	ب ضعاف
بضعف	ب ضعف
بضـــائقة	ب ضائقة
بضـــرب	ب ضرب
بضم	ب ضم
بضمان	ب ضمان
بضمانها	ب ضمان ها
بضمها	ب ضم ها
بضوء	ب ضوء
بضواحى	بضواحى بضواحى
بطائرات	ب طائرات
بطابع	ب طابع
بطاقة	ب طاقة
بطاقته	ب طاقة ه
بطاقتها	بطاقة ها
بطاقتي	بطاقتي بطاقتي
بطب	ب طب
بطبيعة	ب طبيعة
بطرح	ب طرح
بطرد	ب طرد
بطرق	بطرق بطرق
بطريقة	ب طريقة
بطلاب	ب طلاب
بطلاقة	ب طلاقة
بطلب	ب طلب
بطلبات	ب طلبات
بطلعات	بطلعات بطلعات
بطلق	ب طلق
بطلها	بطل ها
بطمي	ب طمي
بطول	ب طول
بطي	ب طي
بظروف	ب ظروف
بظلم	ب ظلم
بعائد	ب عائد
بعام	ب عام
بعاملين	ب عاملين
بعثاتنا	بعثاتنا بعثاتنا
بعثور	بعثور بعثور
بعدة	ب عدة
بعدد	ب عدد
بعدم	ب عدم
بعدما	بعد ما
بعده	بعد ه
بعدها	بعد ها
بعدوى	ب عدوى
بعرض	ب عرض
بعرقلة	ب عرقلة
بعروض	ب عروض
بعزله	ب عزل ه
بعشرات	ب عشرات
بعشرين	ب عشرين
بعشق	ب عشق
بعضها	بعض ها
بعضهم	بعض هم
بعضهما	بعضهما بعضهما
بعظمة	بعظمة بعظمة
بعقد	ب عقد
بعقود	ب عقود
بعكس	ب عكس
بعلاقات	ب علاقات
بعلاقتهم	ب علاقة هم
بعمان	ب عمان
بعمق	ب عمق
بعملهم	ب عمل هم
بعمليات	ب عمليات
بعملية	ب عملية
بعناية	ب عناية
بعنصرى	ب عنصري
بعنف	ب عنف
بعنوان	ب عنوان
بعهد	ب عهد
بعوامل	ب عوامل
بعيار	ب عيار
بعيد	ب عيد
بعيدها	ب عيد ها
بعين	ب عين
بعينه	ب عين ه
بعينها	ب عين ها
بعينهما	بعينهما بعينهما بعينهما
بعيني	ب عيني
بعينيه	ب عيني ه
بغالبية	ب غالبية
بغرب	ب غرب
بغرض	ب غرض
بغرفة	ب غرفة
بغزة	ب غزة
بغزو	ب غزو
بغض	ب غض
بغواصة	ب غواصة
بغير	ب غير
بـنحو	ب نحو
بـه	ب ه
بفئات	ب فئات
بفاعلية	ب فاعلية
بفانوسين	ب فانوسين
بفتح	ب فتح
بفتحة	ب فتحة
بفترة	ب فترة
بفحص	ب فحص
بفرديتها	ب فردية ها
بفرض	ب فرض
بفرقة	ب فرقة
بفريق	ب فريق
بفشل	ب فشل
بفضل	ب فضل
بفعل	ب فعل
بفقدان	بفقدان بفقدان
بفكرة	ب فكرة
بفكره	ب فكر ه
بفوائد	ب فوائد
بفواتير	ب فواتير
بفوز	ب فوز
بفوزه	ب فوز ه
بفوزها	ب فوز ها
بقاءها	بقاءها بقاءها
بقائه	بقاء ه
بقائي	بقائي بقائي
بقاربه	ب قارب ه
بقاعدة	ب قاعدة
بقافلة	بقافلة بقافلة
بقانون	ب قانون
بقبول	ب قبول
بقتل	ب قتل
بقدر	ب قدر
بقدرات	ب قدرات
بقراءة	ب قراءة
بقرار	ب قرار
بقرض	ب قرض
بقرطاج	ب قرطاج
بقروض	ب قروض
بقرية	ب قرية
بقسم	ب قسم
بقصد	ب قصد
بقصر	ب قصر
بقصص	ب قصص
بقصف	ب قصف
بقضاء	بقضاء بقضاء
بقضايا	ب قضايا
بقضية	بقضية بقضية
بقطاع	ب قطاع
بقطاعات	ب قطاعات
بقطر	ب قطر
بقلق	ب قلق
بقلم	ب قلم
بقليل	بقليل بقليل
بقناة	ب قناة
بقوات	ب قوات
بقواعد	ب قواعد
بقوانين	ب قوانين
بقوة	ب قوة
بقوله	ب قول ه
بقولها	ب قول ها
بقوى	ب قوى
بقيادة	ب قيادة
بقيادته	ب قيادة ه
بقيام	ب قيام
بقيد	ب قيد
بقيم	ب قيم
بقيمة	ب قيمة
بكامل	ب كامل
بكامله	ب كامل ه
بكاملها	ب كامل ها
بكبار	ب كبار
بكبسة	بكبسة بكبسة
بكتاب	ب كتاب
بكتابة	ب كتابة
بكثرة	ب كثرة
بكثير	ب كثير
بكد	ب كد
بكشف	ب كشف
بكل	ب كل
بكلام	ب كلام
بكلامه	ب كلام ه
بكلفة	ب كلفة
بكلمة	ب كلمة
بكميات	ب كميات
بكوبا	ب كوبا
بكورسيكا	ب كورسيكا
بكيان	ب كيان
بكيانات	ب كيانات
بكيب	بكيب بكيب
بلا	ب لا
بلادنا	بلادنا بلادنا
بلاده	بلاد ه
بلادها	بلاد ها
بلادهم	بلاد هم
بلادي	بلادي بلادي
بلاعب	ب لاعب
بلبنان	ب لبنان
بلدانها	بلدان ها
بلدانهم	بلدان هم
بلدنا	بلدنا بلدنا
بلده	بلد ه
بلدهم	بلد هم
بلدهما	بلدهما بلدهما
بلسان	ب لسان
بلغة	ب لغة
بلغتهم	ب لغة هم
بلغم	ب لغم
بلقاء	ب لقاء
بلقب	ب لقب
بلقبها	ب لقب ها
بلهجة	ب لهجة
بمؤازرة	ب مؤازرة
بما	ب ما
بماذا	ب ماذا
بمبادئ	ب مبادئ
بمبادرات	ب مبادرات
بمبادرة	ب مبادرة
بمبادرته	ب مبادرة ه
بمبادلة	ب مبادلة
بمبالغ	ب مبالغ
بمبدأ	ب مبدإ
بمبلغ	ب مبلغ
بمبنى	بمبنى بمبنى
بمتابعة	ب متابعة
بمتوسط	ب متوسط
بمثابة	ب مثابة
بمثل	ب مثل
بمثيلتها	بمثيلتها بمثيلتها بمثيلتها
بمجال	بمجال بمجال
بمجالات	ب مجالات
بمجرد	ب مجرد
بمجرى	بمجرى بمجرى
بمجلس	ب مجلس
بمحادثات	ب محادثات
بمحاربة	ب محاربة
بمحاضرتين	ب محاضرتين
بمحاولة	ب محاولة
بمحدودية	بمحدودية بمحدودية
بمخازن	ب مخازن
بمخاطبة	ب مخاطبة
بمخاوف	بمخاوف بمخاوف
بمختلف	ب مختلف
بمخيم	ب مخيم
بمد	ب مد
بمداهمة	ب مداهمة
بمدة	ب مدة
بمدن	ب مدن
بمدى	ب مدى
بمدينة	ب مدينة
بمذبحة	ب مذبحة
بمذكرة	ب مذكرة
بمراجعة	ب مراجعة
بمراقبة	ب مراقبة
بمرتكبيه	ب مرتكبي ه
بمرحلة	ب مرحلة
بمرض	ب مرض
بمرفأ	بمرفأ بمرفأ
بمركز	ب مركز
بمزاولة	ب مزاولة
بمزايا	ب مزايا
بمزرعته	ب مزرعة ه
بمساحات	ب مساحات
بمساحة	بمساحة بمساحة
بمسار	بمسار بمسار
بمساعدة	ب مساعدة
بمساهمات	ب مساهمات
بمستشفى	ب مستشفى
بمستشفيات	ب مستشفيات
بمستقبل	ب مستقبل
بمستوى	ب مستوى
بمستويات	ب مستويات
بمسمار	ب مسمار
بمسيحييه	ب مسيحيي ه
بمشاركة	ب مشاركة
بمشاركتك	ب مشاركة ك
بمشاريع	ب مشاريع
بمشاريعهم	ب مشاريع هم
بمشاعر	ب مشاعر
بمشتقات	بمشتقات بمشتقات
بمشروع	ب مشروع
بمشروعات	ب مشروعات
بمشكلة	بمشكلة بمشكلة
بمصداقية	ب مصداقية
بمصر	ب مصر
بمصلى	ب مصلى
بمضاعفة	ب مضاعفة
بمطار	بمطار بمطار
بمطالب	بمطالب بمطالب
بمظاهرة	ب مظاهرة
بمظهر	ب مظهر
بمعاداة	ب معاداة
بمعاقبة	ب معاقبة
بمعاملته	ب معاملة ه
بمعايير	ب معايير
بمعتمدية	ب معتمدية
بمعدات	ب معدات
بمعدل	ب معدل
بمعدلات	ب معدلات
بمعركة	ب معركة
بمعظم	ب معظم
بمعلومات	ب معلومات
بمعنى	ب معنى
بمعهد	ب معهد
بمغادرة	ب مغادرة
بمفرده	ب مفرد ه
بمفردها	ب مفرد ها
بمفهومه	ب مفهوم ه
بمقارنات	ب مقارنات
بمقاسات	ب مقاسات
بمقاطعة	ب مقاطعة
بمقتضاه	ب مقتضى ه
بمقتضاها	ب مقتضى ها
بمقتضى	ب مقتضى
بمقدار	ب مقدار
بمقر	ب مقر
بمقرات	ب مقرات
بمكاتب	بمكاتب بمكاتب
بمكان	ب مكان
بمكتب	ب مكتب
بمكتبه	ب مكتب ه
بملف	ب ملف
بملكية	ب ملكية
بمليون	ب مليون
بممارسة	ب ممارسة
بممثلي	ب ممثلي
بمن	ب من
بمنأى	ب منأى
بمنازل	بمنازل بمنازل
بمناسبة	ب مناسبة
بمناقشة	ب مناقشة
بمناقصات	ب مناقصات
بمنتجاتها	ب منتجات ها
بمنح	ب منح
بمنصب	ب منصب
بمنطق	ب منطق
بمنطقة	ب منطقة
بمنظار	ب منظار
بمنظمة	ب منظمة
بمنع	ب منع
بمهمة	ب مهمة
بمهمتهما	بمهمتهما بمهمتهما بمهمتهما
بموازاة	ب موازاة
بمواصلة	ب مواصلة
بمواعيد	ب مواعيد
بموافقة	ب موافقة
بمواقف	ب مواقف
بموجب	ب موجب
بموجبه	ب موجب ه
بموظفي	ب موظفي
بموعد	ب موعد
بموقف	ب موقف
بموقفها	ب موقف ها
بموقفهم	ب موقف هم
بمولد	ب مولد
بميزان	ب ميزان
بميزة	ب ميزة
بميلانو	ب ميلانو
بميناء	ب ميناء
بنا	ب نا
بناؤه	بناء ه
بناؤهما	بناؤهما بناؤهما
بنابل	بنابل بنابل
بنتائج	ب نتائج
بنتها	بنت ها
بنجاح	ب نجاح
بنحو	ب نحو
بندقيته	بندقية ه
بنزع	ب نزع
بنسب	ب نسب
بنسبة	ب نسبة
بنشاط	ب نشاط
بنشاطات	ب نشاطات
بنشاطها	ب نشاط ها
بنشر	ب نشر
بنصب	ب نصب
بنصف	بنصف بنصف
بنظام	ب نظام
بنظم	ب نظم
بنظيره	ب نظير ه
بنفس	ب نفس
بنفسه	ب نفس ه
بنفسها	ب نفس ها
بنفط	ب نفط
بنقل	ب نقل
بنهاية	ب نهاية
بنوده	بنوده بنوده
بنودها	بنود ها
بنيته	بنيته بنيته
بنيران	ب نيران
به	ب ه
بها	ب ها
بهاتين	ب هاتين
بهجمات	ب هجمات
بهدف	ب هدف
بهدوء	ب هدوء
بهذا	ب هٰذا
بهذه	ب هٰذه
بهم	ب هم
بهما	ب هما
بهموم	ب هموم
بهونغ	ب هونغ
بهوية	ب هوية
بهويتها	ب هوية ها
بهيئة	ب هيئة
بواجب	ب واجب
بواجبات	ب واجبات
بواجبها	ب واجب ها
بواسطة	ب واسطة
بواشنطن	ب واشنطن
بواقع	ب واقع
بوالدة	ب والدة
بوالده	ب والد ه
بوباء	ب وباء
بوجه	ب وجه
بوجهة	ب وجهة
بوجود	ب وجود
بوجوده	ب وجود ه
بوجودها	ب وجود ها
بوزارة	ب وزارة
بوزراء	ب وزراء
بوزن	ب وزن
بوزير	ب وزير
بوساطة	ب وساطة
بوسط	ب وسط
بوسعنا	بوسعنا بوسعنا بوسعنا
بوسعها	ب وسع ها
بوصف	ب وصف
بوصفه	ب وصف ه
بوضع	ب وضع
بوضوح	ب وضوح
بوظيفته	ب وظيفة ه
بوعدها	ب وعد ها
بوعكة	ب وعكة
بوفاة	ب وفاة
بوفد	ب وفد
بوفرة	ب وفرة
بوفود	ب وفود
بوقت	ب وقت
بوقف	ب وقف
بولاية	ب ولاية
بوهران	ب وهران
بي	بي بي
بيئتهم	بيئة هم
بياناته	بيانات ه
بياناتها	بيانات ها
بيانه	بيان ه
بيانها	بيان ها
بيتنا	بيتنا بيتنا
بيد	ب يد
بيعه	بيع ه
بيعها	بيع ها
بينكما	بينكما بينكما
بينما	بين ما
بيننا	بيننا بيننا
بينه	بين ه
بينها	بين ها
بينهم	بين هم
بينهما	بين هما
بيوم	ب يوم
تأتيك	تأتي ك
تأثيره	تأثير ه
تأثيرها	تأثير ها
تأجيرها	تأجير ها
تأخيرها	تأخير ها
تأديبه	تأديب ه
تأديتهم	تأدية هم
تأزمها	تأزمها تأزمها
تأسيسه	تأسيس ه
تأسيسها	تأسيس ها
تأكيده	تأكيد ه
تأكيدهم	تأكيد هم
تألقها	تألقها تألقها
تأهله	تأهل ه
تأييده	تأييد ه
تأييدها	تأييد ها
تؤازرها	تؤازر ها
تؤهله	تؤهل ه
تؤهلها	تؤهل ها
تاريخه	تاريخ ه
تاريخها	تاريخ ها
تاريخهما	تاريخهما تاريخهما
تبذلها	تبذل ها
تبرئتها	تبرئة ها
تبرمها	تبرم ها
تبعتها	تبعت ها
تبعه	تبع ه
تبناه	تبنى ه
تبنتها	تبنت ها
تبنيها	تبني ها
تتبعها	تتبع ها
تتبناها	تتبنى ها
تتحملها	تتحمل ها
تتخذه	تتخذ ه
تتزعمه	تتزعم ه
تتضمنه	تتضمن ه
تتضمنها	تتضمن ها
تتطلبه	تتطلب ه
تتفهمه	تتفهم ه
تتقاضاه	تتقاضى ه
تتكبدها	تتكبد ها
تتهمها	تتهم ها
تتوقعها	تتوقع ها
تتولاها	تتولى ها
تتويجه	تتويج ه
تتيحها	تتيح ها
تثيره	تثير ه
تجارتهم	تجارة هم
تجاهه	تجاه ه
تجاهها	تجاه ها
تجاوزها	تجاوز ها
تجبرنا	تجبرنا تجبرنا
تجتاحها	تجتاح ها
تجده	تجد ه
تجذيره	تجذير ه
تجربته	تجربة ه
تجربتها	تجربة ها
تجربتهم	تجربة هم
تجسدها	تجسد ها
تجعلها	تجعل ها
تجـــارتهم	تجارة هم
تجمعاتنا	تجمعاتنا تجمعاتنا
تجمعنا	تجمعنا تجمعنا
تجنبه	تجنب ه
تجهيزها	تجهيز ها
تحبطها	تحبط ها
تحبهم	تحب هم
تحتاجه	تحتاجه تحتاجه
تحتاجها	تحتاجها تحتاجها
تحتجزهم	تحتجز هم
تحترمه	تحترم ه
تحتها	تحت ها
تحدثه	تحدث ه
تحدده	تحدد ه
تحددها	تحدد ها
تحرره	تحرره تحرره
تحركها	تحرك ها
تحريرها	تحرير ها
تحصيلها	تحصيل ها
تحققه	تحقق ه
تحققها	تحقق ها
تحقيقه	تحقيق ه
تحكمه	تحكم ه
تحكمها	تحكم ها
تحليقها	تحليق ها
تحليلها	تحليل ها
تحملك	تحمل ك
تحملها	تحمل ها
تحميلها	تحميل ها
تحويلها	تحويل ها
تحياته	تحيات ه
تخبره	تخبر ه
تختطفهم	تختطف هم
تخشاه	تخشى ه
تخصيصه	تخصيص ه
تخصيصها	تخصيص ها
تخليها	تخلي ها
تخوفه	تخوف ه
تداركه	تدارك ه
تداعياته	تداعيات ه
تداوله	تداول ه
تداولها	تداول ها
تدخله	تدخل ه
تدريباتها	تدريبات ها
تدريبهم	تدريب هم
تدريسه	تدريس ه
تدعونا	تدعونا تدعونا
تدعوها	تدعو ها
تدفعها	تدفع ها
تدفعهم	تدفع هم
تديره	تدير ه
تديرها	تدير ها
تذمرهم	تذمر هم
ترأسه	ترأس ه
تراجعه	تراجع ه
تراجعهم	تراجع هم
تراخيصها	تراخيص ها
ترافقها	ترافق ها
تراها	ترى ها
تربطها	تربط ها
تربطهم	تربط هم
تربطهما	تربطهما تربطهما
ترتضيه	ترتضي ه
ترجمتها	ترجمة ها
ترجوه	ترجو ه
ترحيبه	ترحيب ه
ترحيلهم	ترحيل هم
ترسله	ترسل ه
ترشيحهم	ترشيح هم
ترعاه	ترعى ه
تركته	تركت ه
تركه	ترك ه
تركها	ترك ها
تركوها	تركوا ها
تركيبتها	تركيبة ها
تركيزها	تركيز ها
تريده	تريد ه
تريدها	تريد ها
تزورهم	تزور هم
تزييفها	تزييف ها
تسألني	تسأل ني
تساعدنا	تساعدنا تساعدنا
تستخدمه	تستخدم ه
تستخدمها	تستخدم ها
تستدعيه	تستدعي ه
تستضيفها	تستضيف ها
تستقطبهم	تستقطب هم
تستهدفه	تستهدف ه
تستورده	تستورد ه
تستوردها	تستورد ها
تسجيلاته	تسجيلات ه
تسجيلها	تسجيل ها
تسجّلها	تسجل ها
تسديدها	تسديد ها
تسللهم	تسلل هم
تسلمه	تسلم ه
تسليمها	تسليم ها
تسميتها	تسميتها تسميتها
تسميها	تسمي ها
تسهيله	تسهيل ه
تسويته	تسوية ه
تسويقه	تسويق ه
تسويقها	تسويق ها
تسييرها	تسيير ها
تشجيعهم	تشجيع هم
تشغلها	تشغل ها
تشغيله	تشغيل ه
تشغيلها	تشغيل ها
تشكيله	تشكيل ه
تشكيلها	تشكيل ها
تشمله	تشمل ه
تشملهم	تشمل هم
تشنها	تشن ها
تشهده	تشهد ه
تشهدها	تشهد ها
تشيعه	تشيع ه
تشييده	تشييد ه
تشييدها	تشييد ها
تصدره	تصدر ه
تصدرها	تصدر ها
تصديرها	تصدير ها
تصديها	تصدي ها
تصرفاته	تصرفات ه
تصريحاته	تصريحات ه
تصريحه	تصريح ه
تصريفها	تصريف ها
تصعيدها	تصعيد ها
تصفحها	تصفح ها
تصفيتها	تصفية ها
تصميمها	تصميم ها
تصنيعه	تصنيع ه
تصنيعها	تصنيع ها
تضامننا	تضامن نا
تضعها	تضع ها
تضمنه	تضمن ه
تضمنها	تضمن ها
تضمه	تضم ه
تطبقها	تطبق ها
تطبيقه	تطبيق ه
تطبيقها	تطبيق ها
تطرحها	تطرح ها
تطلعاته	تطلعاته تطلعاته
تطلعاتها	تطلعاتها تطلعاتها
تطلعه	تطلع ه
تطوله	تطول ه
تطويره	تطوير ه
تطويرها	تطوير ها
تعازيه	تعازي ه
تعازيها	تعازي ها
تعازيهم	تعازيهم تعازيهم
تعاطفه	تعاطف ه
تعاطيها	تعاطي ها
تعاقده	تعاقد ه
تعاملاتها	تعاملات ها
تعاملك	تعامل ك
تعانيه	تعاني ه
تعاونها	تعاون ها
تعاونهما	تعاونهما تعاونهما
تعبيره	تعبير ه
تعبيرها	تعبيرها تعبيرها
تعتبره	تعتبر ه
تعتبرها	تعتبر ها
تعترضك	تعترض ك
تعرضها	تعرض ها
تعرضهم	تعرض هم
تعرضهن	تعرض هن
تعريفاتهم	تعريفات هم
تعريفه	تعريف ه
تعريفها	تعريف ها
تعريفهم	تعريف هم
تعزيزها	تعزيز ها
تعطينا	تعطينا تعطينا
تعقبها	تعقب ها
تعقيدها	تعقيدها تعقيدها
تعقيمها	تعقيم ها
تعلقهم	تعلق هم
تعلمه	تعلم ه
تعليماته	تعليمات ه
تعليماتهم	تعليمات هم
تعميمه	تعميم ه
تعهداتها	تعهدات ها
تعهده	تعهد ه
تعهدها	تعهد ها
تعيشها	تعيش ها
تعيينه	تعيين ه
تعيينهم	تعيين هم
تفاؤلة	تفاؤلة تفاؤلة
تفاؤله	تفاؤل ه
تفاؤلهم	تفاؤل هم
تفاديه	تفاديه تفاديه
تفرضه	تفرض ه
تفرضها	تفرض ها
تفسيرها	تفسير ها
تفصله	تفصل ه
تفعله	تفعل ه
تفكيره	تفكيره تفكيره
تفكيري	تفكيري تفكيري
تفهمه	تفهم ه
تفوقها	تفوق ها
تقاسمها	تقاسم ها
تقاليدها	تقاليد ها
تقبله	تقبل ه
تقتضيه	تقتضي ه
تقدمه	تقدم ه
تقدمها	تقدم ها
تقديراتها	تقديرات ها
تقديمه	تقديم ه
تقديمها	تقديم ها
تقديمهم	تقديم هم
تقريره	تقرير ه
تقريرها	تقرير ها
تقريرهم	تقرير هم
تقريري	تقريري تقريري
تقسيمها	تقسيم ها
تقليصها	تقليص ها
تقوده	تقود ه
تقودها	تقود ها
تقوله	تقول ه
تقيمه	تقيم ه
تكبدها	تكبد ها
تكذيبه	تكذيب ه
تكريرها	تكرير ها
تكسبها	تكسب ها
تكفيرهم	تكفير هم
تكلفتها	تكلفة ها
تكليفها	تكليف ها
تكليفهم	تكليف هم
تكوينها	تكوين ها
تلاعبها	تلاعبها تلاعبها
تلاه	تلا ه
تلاها	تلا ها
تلتها	تلت ها
تلعبه	تلعب ه
تلقاه	تلقى ه
تلقاها	تلقى ها
تلقتها	تلقت ها
تلقينا	تلقينا تلقينا
تلقيهما	تلقي هما
تليها	تلي ها
تمارسها	تمارس ها
تمتعه	تمتع ه
تمديدها	تمديدها تمديدها
تمكنهم	تمكن هم
تمكينها	تمكين ها
تملكها	تملك ها
تمنحها	تمنح ها
تمنعها	تمنع ها
تمنعهم	تمنع هم
تموله	تمول ه
تمولها	تمول ها
تمويله	تمويل ه
تمويلها	تمويل ها
تناوله	تناول ه
تناولها	تناول ها
تنتهجها	تنتهج ها
تنظيمها	تنظيم ها
تنفذه	تنفذ ه
تنفذها	تنفذ ها
تنفقه	تنفق ه
تنفه	تنف ه
تنفيذه	تنفيذ ه
تنفيذها	تنفيذ ها
تنفيه	تنفي ه
تهددها	تهدد ها
تهديدها	تهديد ها
تهريبهم	تهريب هم
تهمك	تهم ك
تهمه	تهم ه
تواجدها	تواجد ها
تواجهه	تواجه ه
تواجههم	تواجه هم
توافرها	توافر ها
توجهاتهن	توجهات هن
توجهه	توجه ه
توجيهه	توجيه ه
توجيهها	توجيه ها
تورطها	تورط ها
تورطهم	تورط هم
توريدها	توريد ها
توسعه	توسع ه
توصياتها	توصيات ها
توظيفها	توظيف ها
توفره	توفر ه
توفرها	توفر ها
توفرهم	توفر هم
توقعاتها	توقعات ها
توقعهم	توقع هم
توقيتها	توقيت ها
توقيعه	توقيع ه
توقيعها	توقيع ها
توقيعهما	توقيعهما توقيعهما
توليه	تولي ه
توليها	تولي ها
تياراتهم	تيارات هم
ثقافتها	ثقافة ها
ثقبه	ثقب ه
ثقته	ثقة ه
ثلثه	ثلث ه
ثمارها	ثمار ها
ثورتك	ثورة ك
ثوريته	ثوريته ثوريته
جاءني	جاءني جاءني
جانبه	جانب ه
جانبها	جانب ها
جانبي	جانب ي
جدواه	جدوى ه
جدواها	جدوى ها
جذبها	جذب ها
جذورهما	جذورهما جذورهما
جرها	جر ها
جسده	جسد ه
جعلاه	جعلا ه
جعلته	جعلت ه
جعلني	جعلني جعلني
جعله	جعل ه
جعلها	جعل ها
جلساته	جلسات ه
جلسته	جلسة ه
جماهيره	جماهير ه
جمجمتها	جمجمة ها
جمعتهم	جمعت هم
جمعه	جمع ه
جمعها	جمع ها
جمله	جمله جمله
جمهوريتهم	جمهورية هم
جميعها	جميع ها
جناحه	جناحه جناحه
جنبها	جنب ها
جنوبه	جنوب ه
جنوبها	جنوب ها
جنودنا	جنودنا جنودنا
جنوده	جنود ه
جنودها	جنود ها
جهته	جهة ه
جهتها	جهة ها
جهتهم	جهة هم
جهدنا	جهدنا جهدنا
جهده	جهد ه
جهودها	جهود ها
جهودهن	جهود هن
جهوزيته	جهوزية ه
جوائزها	جوائز ها
جوارحه	جوارحه جوارحه
جوانبها	جوانب ها
جولته	جولة ه
جوهره	جوهر ه
حاجاتنا	حاجاتنا حاجاتنا
حاجاتهن	حاجات هن
حالاتهم	حالات هم
حالتك	حالة ك
حالته	حالة ه
حالهم	حال هم
حبه	حب ه
حتفهم	حتف هم
حثه	حث ه
حجتها	حجة ها
حجمها	حجم ها
حداثتي	حداثتي حداثتي
حددته	حددت ه
حددتها	حددت ها
حدده	حدد ه
حده	حد ه
حدوثه	حدوث ه
حدودنا	حدودنا حدودنا
حدودها	حدود ها
حدودهما	حدود هما
حديثه	حديث ه
حذائي	حذائي حذائي
حذرته	حذرت ه
حذرك	حذر ك
حرارته	حرارة ه
حربه	حرب ه
حربها	حرب ها
حرره	حرر ه
حرصه	حرص ه
حرصهما	حرص هما
حريته	حرية ه
حريتهم	حرية هم
حزبه	حزب ه
حزنهم	حزن هم
حساباته	حسابات ه
حسبما	حسب ما
حصته	حصة ه
حصتهما	حصة هما
حصصهم	حصص هم
حصوله	حصول ه
حصولها	حصول ها
حصولهم	حصول هم
حصيلتها	حصيلة ها
حضره	حضر ه
حضرها	حضر ها
حضنه	حضن ه
حضوره	حضور ه
حضورهم	حضور هم
حظرها	حظر ها
حظها	حظ ها
حـــدودهما	حدود هما
حقدهما	حقدهما حقدهما
حققته	حققت ه
حققتها	حققت ها
حققه	حقق ه
حققها	حقق ها
حقكم	حق كم
حقنا	حقنا حقنا
حقه	حق ه
حقها	حق ها
حقهم	حق هم
حقوقه	حقوق ه
حقوقها	حقوق ها
حقوقهن	حقوق هن
حقوله	حقول ه
حقيبته	حقيبة ه
حكمها	حكم ها
حكوماتها	حكومات ها
حكومتنا	حكومتنا حكومتنا
حكومته	حكومة ه
حكومتها	حكومة ها
حلفائه	حلفاء ه
حلفائها	حلفاء ها
حلها	حل ها
حلولها	حلول ها
حماسك	حماس ك
حماسه	حماس ه
حمايته	حماية ه
حمايتها	حماية ها
حملاته	حملاته حملاته
حملته	حملة ه
حملتها	حملة ها
حمله	حمل ه
حملها	حمل ها
حمولتها	حمولة ها
حنيني	حنيني حنيني
حوزتهم	حوزة هم
حولك	حول ك
حوله	حول ه
حولها	حول ها
حياتك	حياة ك
حياته	حياة ه
حياتهم	حياة هم
حياتي	حياتي حياتي
حيازته	حيازة ه
حينما	حين ما
حينه	حين ه
حينها	حين ها
خارجها	خارج ها
خارجيته	خارجية ه
خارجيتها	خارجية ها
خبراتها	خبرات ها
خبراتهم	خبرات هم
خدماته	خدمات ه
خروجها	خروج ها
خسائرها	خسائر ها
خسارتنا	خسارتنا خسارتنا
خسارته	خسارة ه
خسارتها	خسارة ها
خشيتها	خشية ها
خشيتهم	خشية هم
خشيهم	خشي هم
خصصتها	خصصت ها
خصوصياته	خصوصيات ه
خصوصيته	خصوصية ه
خصومهم	خصوم هم
خطابه	خطاب ه
خطابها	خطاب ها
خطاهم	خطى هم
خطته	خطة ه
خطتها	خطة ها
خططك	خطط ك
خطفه	خطف ه
خطوتنا	خطوتنا خطوتنا
خطوتهم	خطوة هم
خفضها	خفض ها
خلافهم	خلاف هم
خلاله	خلال ه
خلالها	خلال ها
خلفته	خلفت ه
خلفتها	خلفت ها
خلفوها	خلفوا ها
خلفيتي	خلفيتي خلفيتي
خليفته	خليفة ه
خولته	خولت ه
خياراتها	خيارات ها
داخله	داخل ه
داخلها	داخل ها
دخله	دخل ه
دخلهم	دخل هم
دخوله	دخول ه
دخولها	دخول ها
دخولهم	دخول هم
دراسته	دراسة ه
دستورنا	دستورنا دستورنا
دعته	دعت ه
دعمنا	دعمنا دعمنا
دعمها	دعم ها
دعمهما	دعم هما
دعني	دعني دعني
دعواه	دعواه دعواه
دفاعنا	دفاعنا دفاعنا
دفعته	دفعت ه
دفعتها	دفعت ها
دفعها	دفع ها
دماؤهم	دماء هم
دماغهم	دماغهم دماغهم
دمجها	دمج ها
دمرتها	دمرت ها
دمرها	دمر ها
دهشته	دهشة ه
دهشتها	دهشة ها
دهشتهم	دهشة هم
دوراته	دورات ه
دورته	دورة ه
دورتهم	دورة هم
دوره	دور ه
دورها	دور ها
دورهم	دور هم
دولتهم	دولة هم
دوله	دول ه
ديارهم	ديار هم
ديننا	ديننا ديننا
ديونك	ديون ك
ديوننا	ديون نا
ديونه	ديون ه
ديونها	ديون ها
ديونهم	ديون هم
ذاته	ذات ه
ذاتها	ذات ها
ذاقها	ذاق ها
ذروته	ذروة ه
ذروتها	ذروة ها
ذكائهم	ذكاء هم
ذكراها	ذكرى ها
ذكرته	ذكرت ه
ذكره	ذكر ه
ذكرها	ذكر ها
رأسماله	رأسمال ه
رأسمالها	رأسمال ها
رأسه	رأس ه
رأسها	رأس ها
رأسهم	رأس هم
رأسهما	رأسهما رأسهما
رأسيهما	رأسي هما
رأيك	رأي ك
رأيه	رأي ه
رأيهم	رأي هم
رؤيتها	رؤية ها
رئاستها	رئاسة ها
رئيسك	رئيس ك
رئيسه	رئيس ه
راسهم	رأس هم
رافقها	رافق ها
رافقوه	رافقوا ه
رايهم	رأي هم
ربطه	ربط ه
ربطها	ربط ها
ربي	ربي ربي
رجاؤنا	رجاؤنا رجاؤنا
رجائنا	رجائنا رجائنا
رجالهم	رجال هم
رجعيتها	رجعية ها
رجوعي	رجوعي رجوعي
رحابه	رحاب ه
رحلاتها	رحلات ها
رحلتها	رحلة ها
رحلتهما	رحلة هما
رحلتي	رحلتي رحلتي
رحلتيهما	رحلتي هما
رحمهم	رحم هم
رددها	ردد ها
رده	رد ه
رذاذه	رذاذه رذاذه
رسائلهم	رسائل هم
رسالته	رسالة ه
رشدهم	رشد هم
رشها	رش ها
رصدها	رصد ها
رصيده	رصيده رصيده
رصيدها	رصيد ها
رضاه	رضا ه
رعاياها	رعايا ها
رعايته	رعاية ه
رعايتها	رعاية ها
رغبتك	رغبة ك
رغبته	رغبة ه
رغبتها	رغبة ها
رغبتهم	رغبة هم
رغبتهما	رغبتهما رغبتهما
رفضه	رفض ه
رفضها	رفض ها
رفضهم	رفض هم
رفعتها	رفعت ها
رفعها	رفع ها
رفيقك	رفيق ك
رقبته	رقبة ه
رقمها	رقم ها
رموزها	رموز ها
رهانه	رهانه رهانه
رواتبهم	رواتب هم
روادها	رواد ها
روحه	روح ه
روزنامته	روزنامة ه
زارها	زار ها
زراعته	زراعة ه
زرتها	زرتها زرتها
زملاؤنا	زملاء نا
زملائه	زملاء ه
زميلاه	زميلا ه
زميله	زميل ه
زميلهم	زميل هم
زنتها	زنة ها
زنزانته	زنزانة ه
زوجته	زوجة ه
زوجتي	زوجة ي
زوجها	زوج ها
زيارته	زيارة ه
سأتشاور	س أتشاور
سأتنازل	سأتنازل سأتنازل
سأحضر	سأحضر سأحضر
سأرفض	سأرفض سأرفض
سأضع	سأضع سأضع
سألته	سألت ه
سألتها	سألت ها
سألني	سألني سألني
سأله	سأل ه
ساعدك	ساعد ك
ساكون	ساكون ساكون
سببها	سبب ها
سبحانه	سبحان ه
سبقته	سبقت ه
سبقتها	سبقت ها
سبقه	سبق ه
سبقوه	سبقوا ه
سبيله	سبيل ه
سبيلها	سبيل ها
ستأتى	س تأتي
ستأتي	س تأتي
ستأخذ	س تأخذ
ستؤثر	س تؤثر
ستؤدي	س تؤدي
ستؤول	س تؤول
ستؤيد	س تؤيد
ستباشر	س تباشر
ستباع	س تباع
ستبدأ	س تبدأ
ستبدأها	س تبدأ ها
ستبذل	س تبذل
ستبقى	س تبقى
ستبقيان	س تبقيان
ستبلغ	س تبلغ
ستتأثر	س تتأثر
ستتجاوز	س تتجاوز
ستتحول	س تتحول
ستتدخل	س تتدخل
ستترك	س تترك
ستتركز	س تتركز
ستتضاعف	س تتضاعف
ستتضرر	س تتضرر
ستتطلب	س تتطلب
ستتم	س تتم
ستتمتع	س تتمتع
ستتمثل	س تتمثل
ستتمكن	س تتمكن
ستتواصل	س تتواصل
ستتوج	س تتوج
ستتيح	س تتيح
ستجتمع	س تجتمع
ستجد	س تجد
ستجرى	س تجري
ستجري	س تجري
ستجريها	س تجري ها
ستجعل	س تجعل
ستجلب	س تجلب
ستحتاج	س تحتاج
ستحدد	س تحدد
ستحصل	س تحصل
ستخرج	س تخرج
ستخضع	س تخضع
ستخوض	س تخوض
ستخيم	س تخيم
ستدخل	س تدخل
ستدرسان	ستدرسان ستدرسان
ستدعو	س تدعو
سترتفع	س ترتفع
سترتكب	س ترتكب
سترد	س ترد
سترسل	س ترسل
سترسلها	س ترسل ها
سترفع	س ترفع
ستركز	س تركز
ستزداد	س تزداد
ستزيد	س تزيد
ستساعد	س تساعد
ستساعدنا	ستساعدنا ستساعدنا ستساعدنا
ستساعدها	س تساعد ها
ستساعدهم	س تساعد هم
ستستأنف	س تستأنف
ستستانف	س تستأنف
ستستجيب	س تستجيب
ستستخدم	س تستخدم
ستستضيف	س تستضيف
ستستغرق	س تستغرق
ستستغل	س تستغل
ستستمر	س تستمر
ستستهدف	س تستهدف
ستسعد	س تسعد
ستسعى	س تسعى
ستسفر	س تسفر
ستسقط	س تسقط
ستسلك	س تسلك
ستسلكه	س تسلك ه
ستسمح	س تسمح
ستشارك	س تشارك
ستشجع	س تشجع
ستشدد	س تشدد
ستشعل	س تشعل
ستشكل	س تشكل
ستشن	س تشن
ستشنها	س تشن ها
ستشهد	س تشهد
ستصبح	س تصبح
ستصدر	س تصدر
ستصل	س تصل
ستضاف	س تضاف
ستضبط	س تضبط
ستضطر	س تضطر
ستضع	س تضع
ستضم	س تضم
ستطالب	س تطالب
ستطرح	س تطرح
ستطلق	س تطلق
ستطول	س تطول
ستظل	س تظل
ستظهر	س تظهر
ستعارض	س تعارض
ستعتقل	س تعتقل
ستعتقلنا	س تعتقل نا
ستعتمد	س تعتمد
ستعدم	س تعدم
ستعرض	س تعرض
ستعرضه	س تعرض ه
ستعزز	س تعزز
ستعززان	س تعززان
ستعقبها	س تعقب ها
ستعقد	س تعقد
ستعقدها	س تعقد ها
ستعلق	س تعلق
ستعلن	س تعلن
ستعمل	س تعمل
ستعمم	س تعمم
ستعود	س تعود
ستعيد	س تعيد
ستعين	س تعين
ستغادر	س تغادر
ستغلق	س تغلق
ستـعلن	س تعلن
ستـــكافح	س تكافح
ستفقد	س تفقد
ستفي	س تفي
ستقام	س تقام
ستقدم	س تقدم
ستقدمه	س تقدم ه
ستقدمها	س تقدم ها
ستقرّره	س تقرر ه
ستقل	س تقل
ستقود	س تقود
ستقوده	س تقود ه
ستقوم	س تقوم
ستكلفهم	س تكلف هم
ستكلّف	س تكلف
ستكلّفنا	ستكلفنا ستكلفنا ستكلفنا
ستكون	س تكون
ستلحق	س تلحق
ستلعب	س تلعب
ستلعبه	س تلعب ه
ستمتنع	س تمتنع
ستمثل	س تمثل
ستمكنك	س تمكن ك
ستمنح	س تمنح
ستنبثق	س تنبثق
ستنتجها	س تنتج ها
ستنتشر	س تنتشر
ستنتظر	س تنتظر
ستنتقل	س تنتقل
ستنتهي	س تنتهي
ستنجز	س تنجز
ستنخفض	س تنخفض
ستنشأ	س تنشأ
ستنشئ	س تنشئ
ستنشر	س تنشر
ستنصب	س تنصب
ستنضم	س تنضم
ستنظر	س تنظر
ستنظم	س تنظم
ستهتم	س تهتم
ستواجه	س تواجه
ستواجهها	س تواجه ها
ستواصل	س تواصل
ستوفر	س توفر
ستوقع	س توقع
ستولى	س تولى
ستُشغل	س تشغل
سجله	سجل ه
سجنهما	سجنهما سجنهما
سحبه	سحب ه
سدادها	سداد ها
سددته	سددت ه
سدها	سد ها
سرعتها	سرعة ها
سرورنا	سرورنا سرورنا
سروره	سرور ه
سطحها	سطح ها
سعره	سعر ه
سعرها	سعر ها
سعيه	سعي ه
سعيها	سعي ها
سفره	سفر ه
سفرهم	سفر هم
سفري	سفري سفري
سفنه	سفن ه
سفيرها	سفير ها
سكانها	سكان ها
سكناهم	سكنى هم
سلاحهم	سلاح هم
سلامتهم	سلامة هم
سلعها	سلع ها
سلفه	سلف ه
سلمه	سلم ه
سلوكهم	سلوكهم سلوكهم
سمعتها	سمعة ها
سمعتي	سمعة ي
سمومهما	سمومهما سمومهما
سنبدأ	س نبدأ
سنجد	سنجد سنجد
سنجدها	س نجد ها
سنجري	سنجري سنجري
سنرسل	سنرسل سنرسل
سنسعى	س نسعى
سنضع	سنضع سنضع
سنعيد	سنعيد سنعيد
سهراته	سهرات ه
سواها	سوى ها
سوقها	سوق ها
سيأتى	س يأتي
سيؤثر	س يؤثر
سيؤدي	س يؤدي
سيادته	سيادة ه
سيادتها	سيادة ها
سيارته	سيارة ه
سياستنا	سياستنا سياستنا
سياسته	سياسة ه
سياستها	سياسة ها
سيبتعد	س يبتعد
سيبحث	س يبحث
سيبدأ	س يبدأ
سيبدأها	س يبدأ ها
سيبذل	س يبذل
سيبعد	س يبعد
سيبقى	س يبقى
سيبقيان	س يبقيان
سيتحتم	س يتحتم
سيترك	س يترك
سيتزايد	س يتزايد
سيتصاعد	س يتصاعد
سيتضمن	س يتضمن
سيتطلب	س يتطلب
سيتعين	س يتعين
سيتم	س يتم
سيتمخض	س يتمخض
سيتناول	س يتناول
سيتواجه	س يتواجه
سيتوجه	س يتوجه
سيتوقعون	س يتوقعون
سيتولى	س يتولى
سيتيح	س يتيح
سيثير	س يثير
سيثيرها	س يثير ها
سيجبر	س يجبر
سيجتمع	س يجتمع
سيجد	س يجد
سيجذب	س يجذب
سيجرى	س يجرى
سيجري	س يجري
سيجعل	س يجعل
سيحالون	س يحالون
سيحاول	س يحاول
سيحترم	س يحترم
سيحدث	س يحدث
سيحرم	س يحرم
سيحصل	س يحصل
سيحكم	س يحكم
سيحل	س يحل
سيحمل	س يحمل
سيختفي	س يختفي
سيخدم	س يخدم
سيخرج	س يخرج
سيخصص	س يخصص
سيخفض	س يخفض
سيخلف	س يخلف
سيخلق	س يخلق
سيخوضها	س يخوض ها
سيدخل	س يدخل
سيدرس	س يدرس
سيدعو	س يدعو
سيدفع	س يدفع
سيدفعك	س يدفع ك
سيرافقه	س يرافق ه
سيربط	س يربط
سيرتفع	س يرتفع
سيرحل	س يرحل
سيرسل	س يرسل
سيرسلون	س يرسلون
سيره	سير ه
سيرها	سير ها
سيزور	س يزور
سيزيد	س يزيد
سيساعد	س يساعد
سيساندهم	س يساند هم
سيساهم	س يساهم
سيستغرقها	س يستغرق ها
سيستلمها	س يستلم ها
سيستمر	س يستمر
سيسعون	س يسعون
سيسعى	س يسعى
سيسفر	س يسفر
سيسلك	س يسلك
سيسمح	س يسمح
سيسهم	س يسهم
سيشارك	س يشارك
سيشاركان	س يشاركان
سيشاركون	س يشاركون
سيشجع	س يشجع
سيشرف	س يشرف
سيشكل	س يشكل
سيشكلون	س يشكلون
سيشهد	س يشهد
سيشهدها	س يشهد ها
سيصدر	س يصدر
سيصدران	س يصدران
سيصطدم	س يصطدم
سيصل	س يصل
سيضع	س يضع
سيضعف	س يضعف
سيضم	س يضم
سيضيف	س يضيف
سيطالبون	س يطالبون
سيطرتها	سيطرة ها
سيطرتهم	سيطرة هم
سيطرح	س يطرح
سيطلق	س يطلق
سيطلقون	س يطلقون
سيطمئنون	س يطمئنون
سيظل	س يظل
سيظهر	س يظهر
سيعالج	س يعالج
سيعاني	س يعاني
سيعتمد	س يعتمد
سيعرض	س يعرض
سيعرف	س يعرف
سيعزز	س يعزز
سيعطي	س يعطي
سيعطينا	سيعطينا سيعطينا سيعطينا
سيعقد	س يعقد
سيعلن	س يعلن
سيعمد	س يعمد
سيعني	س يعني
سيعود	س يعود
سيعيد	س يعيد
سيغادر	س يغادر
سيغرق	س يغرق
سيغطون	س يغطون
سيغطي	س يغطي
سيـــتعين	س يتعين
سيـــتم	س يتم
سيـــجريها	س يجري ها
سيـــقدم	س يقدم
سيفتتح	س يفتتح
سيفتح	س يفتح
سيفرض	س يفرض
سيفعل	س يفعل
سيفيد	س يفيد
سيقابل	س يقابل
سيقام	س يقام
سيقاومون	س يقاومون
سيقترح	س يقترح
سيقدم	س يقدم
سيقدمه	س يقدم ه
سيقدمها	س يقدم ها
سيقدمون	س يقدمون
سيقرأون	س يقرؤون
سيقسم	س يقسم
سيقعون	س يقعون
سيقف	س يقف
سيقوم	س يقوم
سيكلفها	س يكلف ها
سيكون	س يكون
سيلتقي	س يلتقي
سيلتقيان	س يلتقيان
سيلحق	س يلحق
سيلقون	س يلقون
سيلقي	س يلقي
سيمتد	س يمتد
سيمثلون	س يمثلون
سيمر	س يمر
سيمضي	س يمضي
سيمكن	س يمكن
سيمكنه	س يمكن ه
سيمل	س يمل
سيمنح	س يمنح
سيمهد	س يمهد
سيمول	س يمول
سيناقش	س يناقش
سينتج	س ينتج
سينتجه	س ينتج ه
سينتقل	س ينتقل
سينخفض	س ينخفض
سينشط	س ينشط
سينطبق	س ينطبق
سينظر	س ينظر
سينفذ	س ينفذ
سينقل	س ينقل
سينقلان	س ينقلان
سينقلون	س ينقلون
سيهجرك	س يهجر ك
سيواجهون	س يواجهون
سيواصل	س يواصل
سيواصلان	س يواصلان
سيودى	س يودي
سيوسع	س يوسع
سيوصي	س يوصي
سيوفر	س يوفر
سيوقعه	س يوقع ه
سيولد	س يولد
سيولي	س يولي
سيُطبق	س يطبق
سيُعقد	س يعقد
شأنه	شأن ه
شأنها	شأن ها
شأنهم	شأن هم
شؤونه	شؤون ه
شؤونها	شؤونها شؤونها
شئوننا	شئوننا شئوننا
شئونهم	شؤون هم
شاحنتهم	شاحنة هم
شبابها	شباب ها
شحنها	شحن ها
شخصياتهم	شخصيات هم
شراؤه	شراء ه
شراؤها	شراء ها
شرائها	شراء ها
شراكتها	شراكة ها
شربها	شرب ها
شرحها	شرح ها
شرفه	شرف ه
شرقها	شرق ها
شركاءك	شركاء ك
شركائه	شركائه شركائه
شركائها	شركاء ها
شركاته	شركات ه
شركته	شركة ه
شروطنا	شروطنا شروطنا
شروطه	شروط ه
شروطها	شروط ها
شريكتها	شريكتها شريكتها
شريكك	شريك ك
شعاراتها	شعارات ها
شعبنا	شعبنا شعبنا
شعبه	شعب ه
شعبها	شعب ها
شعبي	شعبي شعبي
شعبيته	شعبية ه
شعبيتها	شعبية ها
شعرهم	شعر هم
شعوبنا	شعوبنا شعوبنا
شعوبه	شعوبه شعوبه
شعوبها	شعوبها شعوبها
شعورهم	شعور هم
شفائه	شفاء ه
شفائي	شفائي شفائي
شفيعه	شفيعه شفيعه
شقيقتي	شقيقتي شقيقتي
شكاواهم	شكاواهم شكاواهم
شكلتها	شكلت ها
شكلها	شكل ها
شكليها	شكلي ها
شكواها	شكوى ها
شكواهم	شكوى هم
شملتهم	شملت هم
شملها	شمل ها
شملهم	شمل هم
شنته	شنت ه
شنتها	شنت ها
شنتهما	شنت هما
شنقه	شنقه شنقه
شنه	شن ه
شنها	شن ها
شهاداتها	شهادات ها
شهدته	شهدت ه
شهدتها	شهدت ها
شهرته	شهرة ه
صاحبه	صاحب ه
صاحبها	صاحب ها
صادراتنا	صادرات نا
صادراتها	صادرات ها
صادراتهم	صادرات هم
صحته	صحة ه
صحتها	صحة ها
صدرنا	صدرنا صدرنا
صدورها	صدور ها
صديقاتهن	صديقات هن
صديقه	صديقه صديقه
صديقها	صديق ها
صديقي	صديقي صديقي
صراعها	صراع ها
صرفه	صرف ه
صعوده	صعود ه
صعودهما	صعود هما
صفته	صفة ه
صفحاتها	صفحات ها
صفحتها	صفحة ها
صفقتها	صفقة ها
صفوفه	صفوف ه
صلاحيتها	صلاحية ها
صلتها	صلتها صلتها
صلتهم	صلة هم
صناعاتها	صناعات ها
صواريخها	صواريخ ها
صوتها	صوت ها
صورته	صورة ه
صورتها	صورة ها
صوغه	صوغ ه
صياغتها	صياغة ها
صيانتها	صيانة ها
ضبطهم	ضبط هم
ضحاياه	ضحايا ه
ضحيته	ضحية ه
ضحيتها	ضحيت ها
ضخه	ضخ ه
ضده	ضد ه
ضدها	ضد ها
ضدهم	ضد هم
ضربها	ضرب ها
ضربهما	ضرب هما
ضعفها	ضعف ها
ضمائرهم	ضمائر هم
ضمته	ضمت ه
ضمتها	ضمت ها
ضمنها	ضمن ها
ضمنهم	ضمن هم
ضمها	ضم ها
ضوئها	ضوء ها
ضياعها	ضياع ها
ضيفه	ضيفه ضيفه
طائراتها	طائرات ها
طائرته	طائرة ه
طائرتهم	طائرتهم طائرتهم
طائفتهم	طائفتهم طائفتهم
طابعه	طابع ه
طاقاتهم	طاقات هم
طاقتها	طاقة ها
طاقمها	طاقم ها
طاقميهما	طاقمي هما
طالبها	طالب ها
طالما	طالما طالما
طبعها	طبع ها
طبيعته	طبيعة ه
طبيعتها	طبيعة ها
طرحتها	طرحت ها
طرحه	طرح ه
طرحها	طرح ها
طردتهم	طردت هم
طردها	طرد ها
طريقتهم	طريقة هم
طريقه	طريق ه
طريقها	طريق ها
طريقهم	طريق هم
طــقوسه	طقوس ه
طلابه	طلاب ه
طلاقها	طلاق ها
طلبني	طلبني طلبني
طلبه	طلب ه
طلبهم	طلب هم
طليعتها	طليعة ها
طموحاتك	طموحات ك
طياته	طيات ه
ظهوره	ظهور ه
عائداتها	عائدات ها
عائدها	عائد ها
عائلاتنا	عائلات نا
عائلاتهم	عائلات هم
عائلته	عائلة ه
عارضه	عارض ه
عاشها	عاش ها
عاصمتنـا	عاصمتنـا عاصمتنـا
عاصمتها	عاصمة ها
عافيته	عافية ه
عالمنا	عالمنا عالمنا
عامها	عام ها
عباراتهم	عبارات هم
عبده	عبد ه
عبرناه	عبرناه عبرناه
عبرها	عبر ها
عثورها	عثور ها
عجزها	عجز ها
عداءه	عداءه عداءه
عددها	عدد ها
عددهم	عدد هم
عدمه	عدم ه
عدوانها	عدوان ها
عدوه	عدو ه
عدوي	عدوي عدوي
عرضتها	عرضت ها
عرضه	عرض ه
عرضها	عرض ها
عرفته	عرفته عرفته
عرفتها	عرفت ها
عروبتها	عروبة ها
عزاؤنا	عزاؤنا عزاؤنا
عزلها	عزل ها
عزمه	عزم ه
عزمها	عزم ها
عشقها	عشق ها
عصره	عصره عصره
عظامك	عظام ك
عظمتها	عظمة ها
عقده	عقد ه
عقدها	عقد ها
عقدهما	عقد هما
عقدي	عقدي عقدي
عقولهم	عقول هم
علاجه	علاج ه
علاقاتنا	علاقاتنا علاقاتنا
علاقاتها	علاقات ها
علاقاتهم	علاقات هم
علاقاتهما	علاقاتهما علاقاتهما
علاقتاهما	علاقتاهما علاقتاهما
علاقتك	علاقة ك
علاقتنا	علاقتنا علاقتنا
علاقته	علاقة ه
علاقتها	علاقة ها
علاقتهم	علاقة هم
علمتني	علمتني علمتني
عليك	علي ك
عليكم	علي كم
علينا	علينا علينا
عليه	علي ه
عليها	علي ها
عليهم	علي هم
عليهما	عليهما عليهما
عليهن	علي هن
عما	عن ما
عمالته	عمالة ه
عمالها	عمال ها
عمالهم	عمال هم
عمره	عمر ه
عمرها	عمر ها
عمقه	عمق ه
عملائه	عملاء ه
عملاتها	عملات ها
عملتها	عملة ها
عمله	عمل ه
عملها	عمل ها
عملهم	عمل هم
عملي	عملي عملي
عملياته	عمليات ه
عملياتها	عمليات ها
عملياتهم	عمليات هم
عممته	عممت ه
عمن	عن من
عناصرها	عناصر ها
عناصرهم	عناصر هم
عناه	عنى ه
عنايته	عناية ه
عندما	عند ما
عندنا	عندنا عندنا
عندها	عند ها
عنه	عن ه
عنها	عن ها
عنهم	عن هم
عنهما	عنهما عنهما
عواطفك	عواطف ك
عواقبه	عواقب ه
عودته	عودة ه
عودتهم	عودة هم
عودتي	عودتي عودتي
عيدها	عيد ها
عينته	عينت ه
عينه	عين ه
عينها	عين ها
عينهم	عين هم
عينيه	عيني ه
غادراه	غادرا ه
غادرتها	غادرت ها
غاراته	غارات ه
غالبيتها	غالبية ها
غالبيتهم	غالبية هم
غرقها	غرق ها
غزوه	غزو ه
غضبه	غضب ه
غمرتها	غمرت ها
غناها	غنى ها
غيارها	غيار ها
غير	غير أن ه
غيره	غير ه
غيرها	غير ها
غيرهم	غير هم
فأسعار	فأسعار فأسعار
فأشار	ف أشار
فأشرف	ف أشرف
فأصابت	ف أصابت
فأصبحت	ف أصبحت
فأظل	فأظل فأظل
فأعلمت	ف أعلمت
فأعلمتها	ف أعلمت ها
فأعيد	فأعيد فأعيد
فأقول	فأقول فأقول
فأكثر	ف أكثر
فألغى	ف ألغى
فأهل	فأهل فأهل
فأولى	ف أولى
فأيد	ف أيد
فأين	ف أين
فإدارة	ف إدارة
فإذا	ف إذا
فإن	ف إن
فإنك	ف إن ك
فإنه	ف إن ه
فإنها	ف إن ها
فائدته	فائدة ه
فاجأني	فاجأ ني
فاجاب	ف أجاب
فاحتفظ	ف احتفظ
فاذا	ف إذا
فارسلت	ف أرسلت
فازددنا	فازددنا فازددنا
فاستبدله	ف استبدل ه
فاستغاث	ف استغاث
فاستفضت	فاستفضت فاستفضت
فاستمع	ف استمع
فاصبحوا	ف أصبحوا
فاعترضت	ف اعترضت
فاعترفوا	ف اعترفوا
فاعليته	فاعلية ه
فاعليتها	فاعلية ها
فاقترح	ف اقترح
فالأسوأ	ف الأسوأ
فالاثنان	ف الاثنان
فالانتصار	ف الانتصار
فالبنوك	ف البنوك
فالتأييد	ف التأييد
فالتحق	ف التحق
فالتطرف	فالتطرف فالتطرف
فالتنسيق	فالتنسيق فالتنسيق
فالثابت	ف الثابت
فالجماهير	ف الجماهير
فالحوار	ف الحوار
فالدول	ف الدول
فالرجل	ف الرجل
فالسعودية	ف السعودية
فالسوق	ف السوق
فالشركة	ف الشركة
فالصحف	فالصحف فالصحف
فالطرح	ف الطرح
فالعالم	فالعالم فالعالم
فالفاتيكان	فالفاتيكان فالفاتيكان
فالقفز	ف القفز
فالقيادي	ف القيادي
فالكتاب	فالكتاب فالكتاب
فالمرأة	ف المرأة
فالمسألة	ف المسألة
فالمسافر	ف المسافر
فالمطلوب	فالمطلوب فالمطلوب
فالمعلومات	ف المعلومات
فالمعنى	ف المعنى
فالمفروض	ف المفروض
فالموضوع	ف الموضوع
فالنساء	ف النساء
فالواجب	ف الواجب
فالوضع	فالوضع فالوضع
فان	ف إن
فانا	فانا فانا
فانه	ف إن ه
فانها	ف إن ها
فانهالت	ف انهالت
فب	ف ب
فبات	ف بات
فبادر	ف بادر
فباراك	ف باراك
فباستثناء	ف ب استثناء
فبعد	ف بعد
فبعضها	فبعضها فبعضها فبعضها
فبيريز	ف بيريز
فبين	ف بين
فبينما	ف بينما
فتبين	ف تبين
فتتأكد	ف تتأكد
فتحمل	ف تحمل
فتحهما	فتح هما
فتحول	ف تحول
فتحولت	ف تحولت
فتسبب	ف تسبب
فتسللت	ف تسللت
فتشير	ف تشير
فتعمد	ف تعمد
فتم	ف تم
فتمت	ف تمت
فتمنع	ف تمنع
فتهرب	ف تهرب
فتواه	فتوى ه
فثمة	ف ثمة
فجيش	ف جيش
فحائط	ف حائط
فحجم	ف حجم
فحدث	ف حدث
فحذر	ف حذر
فحسب	ف حسب
فحصها	فحص ها
فحصيلة	ف حصيلة
فحظر	ف حظر
فخذه	فخذه فخذه
فخرها	فخر ها
فخطف	فخطف فخطف
فخلا	ف خلا
فخلال	ف خلال
فدلّسوا	ف دلسوا
فذكروا	ف ذكروا
فذلك	فذلك فذلك
فرأى	ف رأى
فرات	ف رأت
فرحتي	فرحتي فرحتي
فردت	ف ردت
فردود	فردود فردود
فرشها	فرش ها
فرصتها	فرصة ها
فرضته	فرضت ه
فرضتها	فرضت ها
فرضها	فرض ها
فركزت	ف ركزت
فروعها	فروع ها
فريقه	فريق ه
فزادت	ف زادت
فسأرد	فسأرد فسأرد فسأرد
فستكون	ف س تكون
فستناقش	ف س تناقش
فستواصل	ف س تواصل
فسقط	ف سقط
فسلمه	ف سلم ه
فسنجد	فسنجد فسنجد فسنجد
فسنقدم	فسنقدم فسنقدم فسنقدم
فسوريا	ف سوريا
فسوف	ف سوف
فسيجدون	ف س يجدون
فسيكون	ف س يكون
فشمل	ف شمل
فشيء	ف شيء
فشيئا	ف شيئا
فصائله	فصائل ه
فصرنا	فصرنا فصرنا
فضها	فض ها
فطلب	ف طلب
فعاثوا	ف عاثوا
فعادة	ف عادة
فعادوا	ف عادوا
فعالياته	فعاليات ه
فعدّد	ف عدد
فعرفته	فعرفته فعرفته فعرفته
فعله	فعل ه
فعلى	ف على
فغطت	ف غطت
فغطى	ف غطى
ففاز	ف فاز
ففرنسا	ف فرنسا
ففضلاً	ف فضلا
ففي	ف في
فقال	ف قال
فقام	ف قام
فقاموا	ف قاموا
فقتلوه	ف قتلوا ه
فقد	ف قد
فقدانه	فقدان ه
فقدها	فقد ها
فقررت	ف قررت
فقيدنا	فقيدنا فقيدنا
فكان	ف كان
فكانوا	ف كانوا
فكتب	ف كتب
فكل	ف كل
فكلمة	فكلمة فكلمة
فكم	ف كم
فلئن	ف لأن
فلا	ف لا
فلابد	فلابد فلابد فلابد
فلازم	ف لازم
فلدينا	ف لدي نا
فلديها	ف لدي ها
فلسفته	فلسفة ه
فلــم	ف لم
فلقد	فلقد فلقد
فلكي	ف لكي
فلم	ف لم
فلماذا	ف ل ماذا
فلن	ف لن
فلو	ف لو
فليس	ف ليس
فليظهروه	ف ل يظهروا ه
فما	ف ما
فماذا	ف ماذا
فمتى	ف متى
فمثل	ف مثل
فمحطات	ف محطات
فمرحباً	ف مرحبا
فمع	ف مع
فمن	ف من
فنجد	فنجد فنجد
فنحن	ف نحن
فنفت	ف نفت
فنوه	ف نوه
فهداه	ف هدى ه
فهذا	ف هٰذا
فهذه	ف هٰذه
فهل	ف هل
فهم	ف هم
فهمه	فهم ه
فهناك	ف هناك
فهنالك	ف هنالك
فهو	ف هو
فهى	ف هي
فهي	ف هي
فوائضها	فوائض ها
فوريك	فوريك جنوب
فوزه	فوز ه
فوزها	فوز ها
فوصلت	ف وصلت
فوقها	فوق ها
فوليام	فوليام فوليام
فى	في المياه
فيؤكد	ف يؤكد
فيؤكدون	ف يؤكدون
فيتطلب	ف يتطلب
فيتعلق	ف يتعلق
فيتم	فيتم فيتم
فيتوافق	ف يتوافق
فيتوقع	ف يتوقع
فيحدد	ف يحدد
فيرجع	ف يرجع
فيرمون	ف يرمون
فيرى	ف يرى
فيستقل	فيستقل فيستقل
فيشعرون	ف يشعرون
فيشير	ف يشير
فيقول	ف يقول
فيك	في ك
فيلتقي	ف يلتقي
فيما	في ما
فيمكن	ف يمكن
فيه	في ه
فيها	في ها
فيهم	في هم
فيهما	فيهما فيهما
فيوم	ف يوم
قائده	قائد ه
قائماتهـــم	قائمات هم
قابله	قابل ه
قادته	قادت ه
قادتها	قادة ها
قاده	قاد ه
قاربهم	قارب هم
قاعدته	قاعدة ه
قالاه	قالا ه
قالته	قالت ه
قاله	قال ه
قانونها	قانونها قانونها
قبلنا	قبل نا
قبله	قبل ه
قبلها	قبل ها
قبوله	قبول ه
قبولها	قبول ها
قدراتنا	قدراتنا قدراتنا
قدراتهم	قدرات هم
قدرتك	قدرة ك
قدرته	قدرة ه
قدرتها	قدرة ها
قدرتهم	قدرة هم
قدرنا	قدرنا قدرنا
قدره	قدر ه
قدرها	قدر ها
قدمته	قدمت ه
قدمتها	قدمت ها
قدمه	قدم ه
قدمها	قدم ها
قدومه	قدوم ه
قرأته	قرأت ه
قراءته	قراءة ه
قرارنا	قرارنا قرارنا
قراره	قرار ه
قرارها	قرار ها
قراري	قراري قراري
قربها	قرب ها
قررتها	قررت ها
قررها	قرر ها
قريتهم	قرية هم
قسمتها	قسمت ها
قصدهم	قصد هم
قصدوه	قصدوا ه
قصرها	قصر ها
قصفتها	قصفت ها
قضاياه	قضايا ه
قضيته	قضيته قضيته
قضيتي	قضية ي
قطاعاتها	قطاعاتها قطاعاتها
قلبه	قلب ه
قلبي	قلبي قلبي
قلقه	قلق ه
قلقها	قلق ها
قلوبكم	قلوب كم
قلوبنا	قلوبنا قلوبنا
قلوبها	قلوب ها
قناعته	قناعة ه
قناعتهم	قناعة هم
قنبلته	قنبلته قنبلته
قنبلتها	قنبلة ها
قوائمهم	قوائم هم
قواته	قوات ه
قواتها	قوات ها
قواتهم	قوات هم
قواتهما	قواتهما قواتهما
قواعدها	قواعد ها
قوامها	قوام ها
قوانينها	قوانين ها
قوته	قوة ه
قوتها	قوة ها
قوله	قول ه
قولها	قول ها
قولهم	قول هم
قيادته	قيادة ه
قيادتهم	قيادة هم
قيامه	قيام ه
قيامها	قيام ها
قيامهم	قيام هم
قيامهما	قيامهما قيامهما
قيمته	قيمة ه
قيمتها	قيمة ها
كآلية	ك آلية
كأحتجاج	ك احتجاج
كأحدى	ك إحدى
كأداة	ك أداة
كأسهم	ك أسهم
كأصحاب	ك أصحاب
كأصول	ك أصول
كأفراد	ك أفراد
كأقساط	ك أقساط
كأكبر	ك أكبر
كأكراد	كأكراد كأكراد
كأن	كأن كأن
كأول	ك أول
كإشارة	ك إشارة
كاتفاقيات	ك اتفاقيات
كاجزاء	ك أجزاء
كاحتياطات	ك احتياطات
كاحد	كاحد كاحد
كالآتي	ك الآتي
كالأطباء	ك الأطباء
كالاستثمارات	ك الاستثمارات
كالاقبال	ك الإقبال
كالبيتزا	ك البيتزا
كالجبهة	ك الجبهة
كالجنس	ك الجنس
كالخضر	ك الخضر
كالدولار	ك الدولار
كالسعودية	ك السعودية
كالسياحة	ك السياحة
كالسيارات	ك السيارات
كالعادة	ك العادة
كالعدوان	ك العدوان
كالعفن	ك العفن
كالوضع	ك الوضع
كاليورو	ك اليورو
كامتداد	ك امتداد
كاي	ك أي
كبيرينا	كبيري نا
كتابك	كتاب ك
كتابه	كتاب ه
كتابها	كتاب ها
كتذكار	ك تذكار
كتراث	كتراث كتراث
كتلته	كتلته كتلته
كتلك	ك تلك
كجامع	ك جامع
كجزء	ك جزء
كحزب	ك حزب
كحليف	ك حليف
كخادمة	ك خادمة
كخطوة	ك خطوة
كخيار	ك خيار
كدفعة	ك دفعة
كدولة	ك دولة
كذريعة	ك ذريعة
كرؤوس	ك رؤوس
كرئيس	ك رئيس
كرابع	ك رابع
كراتب	ك راتب
كرامتهم	كرامة هم
كرد	ك رد
كروس	ك روس
كسبب	ك سبب
كسلاح	ك سلاح
كسلعة	ك سلعة
كشرط	ك شرط
كشريك	ك شريك
كشعب	ك شعب
كشفها	كشف ها
كصحفيين	ك صحفيين
كصناعة	ك صناعة
كطبقة	ك طبقة
كطرف	ك طرف
كطلب	ك طلب
كطول	ك طول
كظاهرة	ك ظاهرة
كعامل	ك عامل
كعبهم	كعبهم كعبهم
كعداءة	كعداءة كعداءة
كعراقيين	ك عراقيين
كعضو	ك عضو
كعمال	ك عمال
كفاءتها	كفاءة ها
كفرد	كفرد كفرد
كقاعدة	ك قاعدة
كقروض	ك قروض
كقطر	ك قطر
كقوة	ك قوة
كقوتى	ك قوتي
ككل	ك كل
كلاجئين	ك لاجئين
كلاكما	كلاكما كلاكما
كلامي	كلامي كلامي
كلبنات	ك لبنات
كلفته	كلفة ه
كلما	كل ما
كلمته	كلمة ه
كلمتها	كلمة ها
كلنا	كلنا كلنا
كله	كل ه
كلها	كل ها
كما	ك ما
كمبادرة	كمبادرة كمبادرة
كمجرد	ك مجرد
كمحطة	ك محطة
كمدير	ك مدير
كمرجع	ك مرجع
كمرحلة	ك مرحلة
كمرشح	ك مرشح
كمزارع	ك مزارع
كمسابقة	ك مسابقة
كمستشار	ك مستشار
كمصدر	ك مصدر
كمطار	ك مطار
كمطلب	ك مطلب
كمعطى	كمعطى كمعطى
كمعونة	ك معونة
كمفاوض	ك مفاوض
كمن	ك من
كمنصة	كمنصة كمنصة
كمنطقة	ك منطقة
كمواد	ك مواد
كمواطنين	ك مواطنين
كموجات	ك موجات
كمُشغل	ك مشغل
كنائب	ك نائب
كنتيجة	ك نتيجة
كنسبة	ك نسبة
كنوايا	ك نوايا
كنوع	ك نوع
كهدف	ك هدف
كهذا	ك هٰذا
كواحدة	ك واحدة
كوسيلة	ك وسيلة
كوقود	ك وقود
كوكبنا	كوكبنا كوكبنا
كونه	كون ه
كونها	كون ها
كونهم	كون هم
كيسنجر	كيسنجر الذي
لآخر	ل آخر
لآليات	ل آليات
لآلية	ل آلية
لأبعاد	ل أبعاد
لأبعد	ل أبعد
لأبناء	ل أبناء
لأبنائه	ل أبناء ه
لأثيوبيا	ل أثيوبيا
لأجزاء	ل أجزاء
لأجل	ل أجل
لأحد	ل أحد
لأحكام	ل أحكام
لأخذ	ل أخذ
لأداء	ل أداء
لأراض	ل أراض
لأرباحهم	ل أرباح هم
لأرقام	ل أرقام
لأزمة	ل أزمة
لأسباب	ل أسباب
لأستئناف	ل استئناف
لأسجل	لأسجل لأسجل
لأسس	ل أسس
لأسعار	ل أسعار
لأسواق	ل أسواق
لأشخاص	ل أشخاص
لأضواء	ل أضواء
لأعداد	ل أعداد
لأعضاء	ل أعضاء
لأعمال	ل أعمال
لأفران	ل أفران
لأفريقيا	ل أفريقيا
لأفغانستان	ل أفغانستان
لأفكار	ل أفكار
لأقرب	ل أقرب
لأقل	ل أقل
لأكبر	ل أكبر
لأكثر	ل أكثر
لأكراد	ل أكراد
لألواح	ل ألواح
لأمريكا	ل أمريكا
لأمهات	ل أمهات
لأن	ل أن
لأنظمة	ل أنظمة
لأنقرة	ل أنقرة
لأننا	لأننا لأننا
لأنه	لأن ه
لأنها	لأن ها
لأنهم	لأن هم
لأني	لأني لأني
لأهالي	لأهالي لأهالي
لأهمية	ل أهمية
لأوامر	ل أوامر
لأوروبا	ل أوروبا
لأوساطه	ل أوساط ه
لأوغندا	ل أوغندا
لأول	ل أول
لأي	ل أي
لأيام	ل أيام
لأية	ل أية
لإبرام	ل إبرام
لإبقاء	ل إبقاء
لإتمام	ل إتمام
لإثبات	ل إثبات
لإجبار	ل إجبار
لإجراء	ل إجراء
لإجماع	ل إجماع
لإحالتهم	ل إحالة هم
لإحدى	ل إحدى
لإحصائية	ل إحصائية
لإحكام	ل إحكام
لإحياء	ل إحياء
لإخراج	ل إخراج
لإخواننا	لإخواننا لإخواننا لإخواننا
لإدارة	ل إدارة
لإدانتهم	ل إدانة هم
لإدراج	ل إدراج
لإرجاع	ل إرجاع
لإزالة	ل إزالة
لإسرائيل	ل إسرائيل
لإسلاميين	ل إسلاميين
لإشارات	ل إشارات
لإشعار	ل إشعار
لإشعاره	ل إشعار ه
لإصدار	ل إصدار
لإصلاح	ل إصلاح
لإضافة	ل إضافة
لإعادة	ل إعادة
لإعداد	ل إعداد
لإعطاء	ل إعطاء
لإعلان	ل إعلان
لإعمار	ل إعمار
لإغلاق	ل إغلاق
لإقامة	ل إقامة
لإقرار	ل إقرار
لإقراره	ل إقرار ه
لإقناع	ل إقناع
لإقناعها	ل إقناع ها
لإقناعهما	ل إقناع هما
لإلزام	ل إلزام
لإلغاء	ل إلغاء
لإلياس	ل إلياس
لإمدادها	ل إمداد ها
لإنتاج	ل إنتاج
لإنجازات	ل إنجازات
لإنشاء	ل إنشاء
لإنعاش	ل إنعاش
لإنقاذ	ل إنقاذ
لإنهاء	ل إنهاء
لإنهائه	ل إنهاء ه
لإيقاف	ل إيقاف
لئلا	لئلا لئلا
لابد	لا بد
لابرام	ل إبرام
لابقاء	ل إبقاء
لابناء	لابناء لابناء
لابنه	ل ابن ه
لاتحاد	ل اتحاد
لاتخاذ	ل اتخاذ
لاتزال	لا تزال
لاتصاله	ل اتصال ه
لاتفاق	ل اتفاق
لاتفاقيات	ل اتفاقيات
لاتفاقية	ل اتفاقية
لاتهامه	ل اتهام ه
لاتهامها	ل اتهام ها
لاثار	ل آثار
لاثبات	لاثبات لاثبات
لاثينا	ل أثينا
لاجبار	لاجبار لاجبار
لاجتثاث	ل اجتثاث
لاجتذاب	ل اجتذاب
لاجتماع	ل اجتماع
لاجراء	ل إجراء
لاجراءات	ل إجراءات
لاجل	ل أجل
لاجلاء	ل إجلاء
لاحباط	ل إحباط
لاحترام	لاحترام لاحترام
لاحتلال	ل احتلال
لاحتواء	ل احتواء
لاحتياطيات	ل احتياطيات
لاحد	ل أحد
لاحداث	ل إحداث
لاحدى	ل إحدى
لاحزاب	لاحزاب لاحزاب
لاحصاءات	ل إحصاءات
لاحكام	ل أحكام
لاحلال	ل إحلال
لاحياء	لاحياء لاحياء
لاختبار	ل اختبار
لاختراق	ل اختراق
لاختيار	ل اختيار
لاخذ	ل أخذ
لاخر	ل آخر
لاخراج	لاخراج لاخراج
لاخلاء	ل إخلاء
لادارة	ل إدارة
لادارتها	ل إدارة ها
لاذاعة	ل إذاعة
لاربعة	لاربعة لاربعة
لارتفاع	ل ارتفاع
لارييل	ل أرييل
لازالة	لازالة لازالة
لازدهار	ل ازدهار
لازمة	ل أزمة
لازياء	ل أزياء
لاسباب	ل أسباب
لاستئجار	ل استئجار
لاستئناف	ل استئناف
لاستبعاد	ل استبعاد
لاستبعادهم	ل استبعاد هم
لاستثمار	ل استثمار
لاستثمارات	ل استثمارات
لاستثماراتهم	ل استثمارات هم
لاستجواب	ل استجواب
لاستحواذ	لاستحواذ لاستحواذ
لاستخدام	ل استخدام
لاستخلاص	ل استخلاص
لاستدانة	ل استدانة
لاستدعاء	ل استدعاء
لاستردادها	ل استرداد ها
لاستسلام	لاستسلام لاستسلام
لاستصدار	ل استصدار
لاستصلاح	ل استصلاح
لاستضافة	ل استضافة
لاستعادة	ل استعادة
لاستغلال	ل استغلال
لاستقبال	ل استقبال
لاستقرار	ل استقرار
لاستقطاب	ل استقطاب
لاستكمال	ل استكمال
لاستماع	لاستماع لاستماع
لاستمرار	ل استمرار
لاستهدافها	ل استهداف ها
لاستيراد	ل استيراد
لاستيعاب	ل استيعاب
لاسر	لاسر لاسر
لاسرائيل	ل إسرائيل
لاسطبلات	ل إسطبلات
لاسطول	ل أسطول
لاسعار	ل أسعار
لاسهم	ل أسهم
لاسيما	لا سي ما
لاصابة	ل إصابة
لاصابته	ل إصابة ه
لاصحاب	لاصحاب لاصحاب
لاصدار	ل إصدار
لاصطحاب	ل اصطحاب
لاصطدام	ل اصطدام
لاصطياد	لاصطياد لاصطياد
لاصلاح	ل إصلاح
لاضاعة	لاضاعة لاضاعة
لاضرار	ل أضرار
لاطاحة	ل إطاحة
لاطــــلاع	لاطــــلاع لاطــــلاع
لاطلاعهم	ل اطلاع هم
لاطلاق	ل إطلاق
لاعادة	ل إعادة
لاعادتها	ل إعادة ها
لاعاقات	لا عاقات
لاعاقتها	ل إعاقة ها
لاعبه	لاعب ه
لاعبيه	لاعبي ه
لاعتبارات	ل اعتبارات
لاعتداء	ل اعتداء
لاعتراض	ل اعتراض
لاعتقادهم	ل اعتقاد هم
لاعداد	ل إعداد
لاعضاء	ل أعضاء
لاعطاء	ل إعطاء
لاعلاء	لاعلاء لاعلاء
لاعلام	لاعلام لاعلام
لاعلان	ل إعلان
لاعمال	ل أعمال
لاعماله	ل أعمال ه
لاعمالها	ل أعمال ها
لاغتيال	ل اغتيال
لاغتياله	ل اغتيال ه
لاغراض	ل أغراض
لافتتاح	ل افتتاح
لافراد	ل أفراد
لافريقيا	ل أفريقيا
لافغانستان	ل أفغانستان
لافناء	لافناء لافناء
لافينتاخادو	ل أفينتاخادو
لاقامة	ل إقامة
لاقتحام	ل اقتحام
لاقليم	لاقليم لاقليم
لاقناع	ل إقناع
لاقوال	ل أقوال
لاقول	ل أقول
لاكاديمية	ل أكاديمية
لاكثر	ل أكثر
لاكساب	ل إكساب
لاكمال	ل إكمال
لالتزاماتها	ل التزامات ها
لالعاب	ل ألعاب
لالغاء	لالغاء لالغاء
لالقاء	ل إلقاء
لالمانيا	ل ألمانيا
لالواح	ل ألواح
لامتصاص	ل امتصاص
لامتلاكهم	ل امتلاك هم
لامدادات	ل إمدادات
لامدادها	ل إمداد ها
لامرأة	ل امرأة
لامراض	ل أمراض
لان	ل أن
لانبوب	ل أنبوب
لانتاج	ل إنتاج
لانتخاب	ل انتخاب
لانتزاع	ل انتزاع
لانتشار	لانتشار لانتشار
لانجاح	ل إنجاح
لانجاز	ل إنجاز
لانخفاض	ل انخفاض
لاندية	ل أندية
لانزال	ل إنزال
لانساب	ل أنساب
لانشاء	ل إنشاء
لانضمام	ل انضمام
لانعرفه	لا نعرف ه
لانفجار	ل انفجار
لانقاذ	ل إنقاذ
لانقاذه	ل إنقاذ ه
لانقاذها	ل إنقاذ ها
لانقسام	ل انقسام
لانقلاب	ل انقلاب
لاننا	لأن نا
لانه	لأن ه
لانها	لأن ها
لانهاء	ل إنهاء
لانهائها	ل إنهاء ها
لانهيار	ل انهيار
لاهمية	ل أهمية
لاوامر	ل أوامر
لاوتي	ل أوتي
لاوكرانيا	لاوكرانيا لاوكرانيا
لاول	ل أول
لاولئك	ل أولٰئك
لاى	ل أي
لاي	ل أي
لاية	ل أية
لايتوافر	لا يتوافر
لايجاد	لايجاد لايجاد
لايران	ل إيران
لايزال	لا يزال
لايستطيع	لا يستطيع
لايعول	لا يعول
لايقل	لا يقل
لايمكن	لا يمكن
لباقي	ل باقي
لبحث	ل بحث
لبحرية	لبحرية لبحرية
لبدء	ل بدء
لبداية	لبداية لبداية
لبراءات	ل براءات
لبرلمان	ل برلمان
لبرنامج	ل برنامج
لبريطانيا	ل بريطانيا
لبضعة	لبضعة لبضعة
لبطولة	ل بطولة
لبعث	ل بعث
لبعد	ل بعد
لبعض	ل بعض
لبغداد	ل بغداد
لبقائها	ل بقاء ها
لبلاد	ل بلاد
لبلاده	ل بلاد ه
لبلدة	ل بلدة
لبلورة	ل بلورة
لبناء	ل بناء
لبنك	ل بنك
لبنكي	ل بنكي
لبنيوية	ل بنيوية
لبورصة	ل بورصة
لبوليصة	ل بوليصة
لبيئة	ل بيئة
لبيانه	ل بيان ه
لبيت	ل بيت
لبيروت	ل بيروت
لبيع	ل بيع
لبيعه	ل بيع ه
لبيعها	ل بيع ها
لتأجيل	ل تأجيل
لتأخذ	ل تأخذ
لتأريخ	ل تأريخ
لتأسيس	ل تأسيس
لتأمين	ل تأمين
لتأهيل	ل تأهيل
لتأييد	لتأييد لتأييد
لتايلاند	ل تايلاند
لتبادل	ل تبادل
لتبث	ل تبث
لتبديد	لتبديد لتبديد
لتبرير	ل تبرير
لتبلغ	ل تبلغ
لتبني	ل تبني
لتتأكد	ل تتأكد
لتتجنب	ل تتجنب
لتتسلل	ل تتسلل
لتتكيف	ل تتكيف
لتتماشى	ل تتماشى
لتتوافق	ل تتوافق
لتتولى	ل تتولى
لتثبيت	ل تثبيت
لتجارة	ل تجارة
لتجميد	ل تجميد
لتجميع	ل تجميع
لتجنب	ل تجنب
لتجنيد	ل تجنيد
لتجهيز	ل تجهيز
لتحاليل	لتحاليل لتحاليل
لتحتل	ل تحتل
لتحجيم	ل تحجيم
لتحدي	ل تحدي
لتحديث	ل تحديث
لتحديد	ل تحديد
لتحرير	ل تحرير
لتحريض	ل تحريض
لتحريك	ل تحريك
لتحسن	ل تحسن
لتحسين	ل تحسين
لتحصيل	ل تحصيل
لتحط	ل تحط
لتحفيز	لتحفيز لتحفيز
لتحقيق	ل تحقيق
لتحقيقه	ل تحقيق ه
لتحقيقها	ل تحقيق ها
لتحلية	ل تحلية
لتحويل	ل تحويل
لتحويلها	ل تحويل ها
لتخزين	ل تخزين
لتخصيص	ل تخصيص
لتخفيض	ل تخفيض
لتداول	ل تداول
لتدخل	ل تدخل
لتدخله	ل تدخل ه
لتدخلها	ل تدخل ها
لتدخين	ل تدخين
لتدريب	ل تدريب
لتدعيم	ل تدعيم
لتدمير	ل تدمير
لتراجع	ل تراجع
لتراجعه	ل تراجع ه
لترتفع	ل ترتفع
لترجمة	لترجمة لترجمة
لترسيخ	ل ترسيخ
لترسيــخ	لترسيــخ لترسيــخ
لترسيم	ل ترسيم
لترشيد	ل ترشيد
لترفع	ل ترفع
لتركيا	ل تركيا
لتركيبتها	ل تركيبة ها
لترميم	ل ترميم
لترويج	ل ترويج
لترى	ل ترى
لتزويد	ل تزويد
لتساعد	ل تساعد
لتساعدنا	لتساعدنا لتساعدنا لتساعدنا
لتساقط	ل تساقط
لتستولي	ل تستولي
لتسجل	ل تسجل
لتسريع	ل تسريع
لتسع	ل تسع
لتسلم	ل تسلم
لتسلمهم	ل تسلم هم
لتسليمه	ل تسليم ه
لتسهيل	ل تسهيل
لتسهيلات	ل تسهيلات
لتسوية	ل تسوية
لتسويتها	ل تسوية ها
لتسويق	ل تسويق
لتشابه	ل تشابه
لتشجيع	ل تشجيع
لتشــــمل	ل تشمل
لتشكيل	ل تشكيل
لتشلسي	ل تشلسي
لتصبح	ل تصبح
لتصحيح	لتصحيح لتصحيح
لتصدير	ل تصدير
لتصديره	ل تصدير ه
لتصريحات	ل تصريحات
لتصفيات	ل تصفيات
لتصفية	ل تصفية
لتصل	ل تصل
لتصنيع	ل تصنيع
لتصويب	لتصويب لتصويب
لتصوير	ل تصوير
لتضمن	لتضمن لتضمن
لتطبيق	ل تطبيق
لتطرق	ل تطرق
لتطلعات	ل تطلعات
لتطور	ل تطور
لتطوير	ل تطوير
لتطويق	ل تطويق
لتعاملات	ل تعاملات
لتعاود	ل تعاود
لتعاون	ل تعاون
لتعديل	ل تعديل
لتعزيز	ل تعزيز
لتعزيزها	ل تعزيز ها
لتعطيل	ل تعطيل
لتعليل	ل تعليل
لتعليم	ل تعليم
لتعود	ل تعود
لتعويض	ل تعويض
لتغطية	ل تغطية
لتغيير	ل تغيير
لتفادي	ل تفادي
لتفاقم	ل تفاقم
لتفجير	ل تفجير
لتفجيرها	ل تفجير ها
لتفريخ	ل تفريخ
لتفريغها	ل تفريغ ها
لتفسير	ل تفسير
لتفعيل	ل تفعيل
لتفقد	لتفقد لتفقد
لتفهمها	ل تفهم ها
لتفوقه	ل تفوق ه
لتقتصر	ل تقتصر
لتقديم	ل تقديم
لتقرير	ل تقرير
لتقصي	لتقصي لتقصي
لتقليص	ل تقليص
لتقليل	ل تقليل
لتقنين	ل تقنين
لتقوم	ل تقوم
لتقويم	ل تقويم
لتقييم	ل تقييم
لتكثيف	ل تكثيف
لتكرير	لتكرير لتكرير
لتكريس	ل تكريس
لتكشف	ل تكشف
لتكنولوجيا	ل تكنولوجيا
لتكون	ل تكون
لتكوين	ل تكوين
لتل	ل تل
لتلبية	ل تلبية
لتلزيمهما	لتلزيمهما لتلزيمهما لتلزيمهما
لتلفزيون	ل تلفزيون
لتلقى	ل تلقي
لتلقي	ل تلقي
لتلك	ل تلك
لتمثيل	ل تمثيل
لتمثيلها	ل تمثيل ها
لتمديد	ل تمديد
لتمرير	لتمرير لتمرير
لتمريره	ل تمرير ه
لتمضي	ل تمضي
لتمكين	لتمكين لتمكين
لتمكينهما	لتمكينهما لتمكينهما لتمكينهما
لتمهد	ل تمهد
لتمويل	ل تمويل
لتموين	ل تموين
لتنسيق	ل تنسيق
لتنشيط	ل تنشيط
لتنطلق	ل تنطلق
لتنفيذ	ل تنفيذ
لتنفيذه	ل تنفيذ ه
لتنقية	ل تنقية
لتنمية	ل تنمية
لتهجير	ل تهجير
لتهدئة	ل تهدئة
لتهنئة	ل تهنئة
لتهيئة	لتهيئة لتهيئة
لتواجدنا	لتواجدنا لتواجدنا لتواجدنا
لتوازن	ل توازن
لتواصل	ل تواصل
لتوجيه	ل توجيه
لتوجيهات	ل توجيهات
لتوحيد	ل توحيد
لتوريد	ل توريد
لتوزيع	ل توزيع
لتوسيع	ل توسيع
لتوصيل	ل توصيل
لتوطين	ل توطين
لتوظيفهما	لتوظيفهما لتوظيفهما لتوظيفهما
لتوعيتهم	ل توعية هم
لتوعيتهن	ل توعية هن
لتوفير	ل توفير
لتوفيق	ل توفيق
لتولي	ل تولي
لتوليد	ل توليد
لتونس	لتونس لتونس
لتوّه	لتوه لتوه
لثبت	ل ثبت
لثبوت	ل ثبوت
لثقافته	ل ثقافة ه
لثلاث	ل ثلاث
لثلاثة	ل ثلاثة
لثلاثين	ل ثلاثين
لثلثها	ل ثلث ها
لثمانية	ل ثمانية
لجامعة	ل جامعة
لجثتين	ل جثتين
لجدولة	ل جدولة
لجذب	ل جذب
لجراحة	ل جراحة
لجرحى	ل جرحى
لجريمة	ل جريمة
لجعل	ل جعل
لجعلها	ل جعل ها
لجماعة	ل جماعة
لجمع	ل جمع
لجمعيات	ل جمعيات
لجمعية	ل جمعية
لجمعيته	ل جمعية ه
لجمهورية	ل جمهورية
لجميع	ل جميع
لجنسياتهم	ل جنسيات هم
لجنوب	ل جنوب
لجهة	ل جهة
لجهده	ل جهد ه
لجهود	ل جهود
لجودة	ل جودة
لجوقات	لجوقات لجوقات
لجيش	ل جيش
لجيل	ل جيل
لجيلين	ل جيلين
لحائزي	ل حائزي
لحالات	ل حالات
لحالة	ل حالة
لحاملها	ل حامل ها
لحث	لحث لحث
لحجب	ل حجب
لحجم	ل حجم
لحد	ل حد
لحدة	ل حدة
لحدوث	ل حدوث
لحرب	ل حرب
لحركة	ل حركة
لحرية	ل حرية
لحزب	ل حزب
لحساب	ل حساب
لحسابها	ل حساب ها
لحسم	ل حسم
لحسني	لحسني لحسني
لحصار	ل حصار
لحصص	ل حصص
لحصصها	ل حصص ها
لحصول	ل حصول
لحصولنا	لحصولنا لحصولنا لحصولنا
لحضور	ل حضور
لحضوره	ل حضور ه
لحطام	لحطام لحطام
لحفظ	ل حفظ
لحقائب	لحقائب لحقائب
لحقها	لحق ها
لحقوق	ل حقوق
لحكومة	ل حكومة
لحكومتنا	ل حكومة نا
لحل	ل حل
لحماية	ل حماية
لحمله	ل حمل ه
لحوادث	ل حوادث
لحوالى	ل حوالى
لحوالي	ل حوالى
لحي	ل حي
لحياة	ل حياة
لحياتنا	ل حياة نا
لحين	ل حين
لخارج	ل خارج
لخدمات	ل خدمات
لخدمة	ل خدمة
لخروجها	ل خروج ها
لخريطة	ل خريطة
لخسائر	ل خسائر
لخطأ	لخطأ لخطأ
لخطر	ل خطر
لخطط	ل خطط
لخطف	ل خطف
لخطفهم	ل خطف هم
لخطوات	ل خطوات
لخطورة	ل خطورة
لخفض	ل خفض
لخلافات	ل خلافات
لخلافة	ل خلافة
لخلط	ل خلط
لخلق	ل خلق
لخلو	ل خلو
لخمسين	ل خمسين
لخنقهم	ل خنق هم
لخوض	ل خوض
لدار	ل دار
لدبابة	ل دبابة
لدخول	ل دخول
لدراسات	ل دراسات
لدراسة	ل دراسة
لدرجة	ل درجة
لدرس	ل درس
لدرسها	ل درس ها
لدعم	ل دعم
لدعمكم	ل دعم كم
لدعمهم	ل دعم هم
لدفع	ل دفع
لدقائق	ل دقائق
لدليل	ل دليل
لدمج	ل دمج
لدمشق	ل دمشق
لدواعي	ل دواعي
لدورة	ل دورة
لدوري	ل دوري
لدول	ل دول
لدولارات	ل دولارات
لدولة	ل دولة
لدي	لدي لدي
لديارهم	ل ديار هم
لديك	لدي ك
لدين	لدين لدين
لدينا	لدي نا
لديه	لدي ه
لديها	لدي ها
لديهم	لدي هم
لديهما	لدي هما
لديون	ل ديون
لذاته	ل ذات ه
لذلك	ل ذٰلك
لرأس	ل رأس
لرأسي	ل رأسي
لرؤساء	ل رؤساء
لرؤيتهم	ل رؤية هم
لرئاسة	لرئاسة لرئاسة
لرئيس	ل رئيس
لرئيسه	ل رئيس ه
لرئيسها	ل رئيس ها
لرب	ل رب
لرجال	ل رجال
لرجل	ل رجل
لرحمة	لرحمة لرحمة
لرخص	ل رخص
لرد	ل رد
لرسم	ل رسم
لرصد	ل رصد
لرضا	لرضا لرضا
لرعاية	ل رعاية
لرغباتها	ل رغبات ها
لرفض	ل رفض
لرفع	ل رفع
لرفعها	ل رفع ها
لرقابة	ل رقابة
لرواتب	ل رواتب
لروح	ل روح
لروسيا	ل روسيا
لرومانيا	ل رومانيا
لرياضة	ل رياضة
لزراعتها	ل زراعة ها
لزيادة	ل زيادة
لزيادته	ل زيادة ه
لزيارة	ل زيارة
لزيارته	ل زيارة ه
لسائر	لسائر لسائر
لساني	لساني لساني
لسبب	ل سبب
لسحب	ل سحب
لسد	ل سد
لسداد	ل سداد
لسرعة	ل سرعة
لسريان	ل سريان
لسريلانكا	ل سريلانكا
لسعر	ل سعر
لسقوط	ل سقوط
لسكك	ل سكك
لسلاح	ل سلاح
لسلامة	ل سلامة
لسلسلة	ل سلسلة
لسلطات	ل سلطات
لسلطة	ل سلطة
لسلع	ل سلع
لسلعها	ل سلع ها
لسلفه	ل سلف ه
لسلوك	ل سلوك
لسماحة	ل سماحة
لسماحته	ل سماحة ه
لسماع	ل سماع
لسنة	ل سنة
لسنوات	ل سنوات
لسهولة	ل سهولة
لسواهم	ل سوى هم
لسوريا	ل سوريا
لسورية	ل سورية
لسوق	ل سوق
لسياحة	ل سياحة
لسيادة	ل سيادة
لسيادته	ل سيادة ه
لسياسات	ل سياسات
لسياسة	ل سياسة
لسيطرة	ل سيطرة
لشؤون	ل شؤون
لشئون	ل شؤون
لشارون	ل شارون
لشبابنا	ل شباب نا
لشبكات	ل شبكات
لشبهة	ل شبهة
لشتى	لشتى لشتى
لشخصيات	ل شخصيات
لشراء	ل شراء
لشرح	ل شرح
لشرق	ل شرق
لشركائها	ل شركاء ها
لشركات	ل شركات
لشركاتهم	ل شركات هم
لشركة	ل شركة
لشركتين	ل شركتين
لشروط	لشروط لشروط
لشظية	ل شظية
لشعب	ل شعب
لشعبها	ل شعب ها
لشغل	ل شغل
لشغلها	ل شغل ها
لشفافية	ل شفافية
لشفط	ل شفط
لشكاوى	ل شكاوى
لشكره	ل شكر ه
لشمال	لشمال لشمال
لشن	ل شن
لشهداء	لشهداء لشهداء
لشهر	ل شهر
لشيخ	ل شيخ
لصاحبته	ل صاحبة ه
لصادرات	ل صادرات
لصادراتنا	لصادراتنا لصادراتنا لصادراتنا
لصافي	ل صافي
لصالح	ل صالح
لصالحها	ل صالح ها
لصبر	ل صبر
لصحيفة	ل صحيفة
لصدام	ل صدام
لصديقها	ل صديق ها
لصعوبة	ل صعوبة
لصعوبـــة	ل صعوبة
لصغار	ل صغار
لصفقات	ل صفقات
لصناعات	ل صناعات
لصناعة	ل صناعة
لصندوق	ل صندوق
لصنع	ل صنع
لصواب	لصواب لصواب
لصورة	ل صورة
لصوغ	ل صوغ
لصون	ل صون
لضبط	ل ضبط
لضبطها	ل ضبط ها
لضحايا	ل ضحايا
لضخ	ل ضخ
لضرب	ل ضرب
لضغوط	ل ضغوط
لضمان	ل ضمان
لطائرات	ل طائرات
لطائراته	ل طائرات ه
لطائرة	ل طائرة
لطاقم	ل طاقم
لطالما	لطالما لطالما
لطبيعة	ل طبيعة
لطراز	ل طراز
لطرح	ل طرح
لطرحها	ل طرح ها
لطرف	ل طرف
لطرفي	ل طرفي
لطريقة	ل طريقة
لطعنه	ل طعن ه
لطلاب	ل طلاب
لطلب	ل طلب
لطلبات	ل طلبات
لطن	ل طن
لطهران	ل طهران
لظاهرة	ل ظاهرة
لظروف	ل ظروف
لعائد	ل عائد
لعائلات	ل عائلات
لعائلة	ل عائلة
لعاصمة	ل عاصمة
لعام	ل عام
لعبد	لعبد لعبد
لعبدالحميد	ل عبدالحميد
لعجز	ل عجز
لعدة	ل عدة
لعدد	ل عدد
لعدم	ل عدم
لعديد	ل عديد
لعراق	لعراق لعراق
لعربة	ل عربة
لعرض	ل عرض
لعرضه	ل عرض ه
لعرضها	ل عرض ها
لعرفات	لعرفات لعرفات
لعزل	ل عزل
لعشائر	لعشائر لعشائر
لعشر	ل عشر
لعشرات	ل عشرات
لعشرين	ل عشرين
لعصام	لعصام لعصام
لعقد	ل عقد
لعقوبات	ل عقوبات
لعل	ل عل
لعلاج	ل علاج
لعلاقات	ل علاقات
لعلماء	ل علماء
لعمال	ل عمال
لعمان	لعمان لعمان
لعمل	ل عمل
لعملها	ل عمل ها
لعمليات	ل عمليات
لعملية	ل عملية
لعمولات	لعمولات لعمولات
لعناية	ل عناية
لعوامل	ل عوامل
لعودة	ل عودة
لعيب	ل عيب
لغالبية	ل غالبية
لغتهم	لغة هم
لغرب	ل غرب
لغرف	ل غرف
لغرفة	ل غرفة
لغزو	ل غزو
لغسان	لغسان لغسان
لغسيل	ل غسيل
لغضب	ل غضب
لغواصة	ل غواصة
لغيرنا	لغيرنا لغيرنا لغيرنا
لغيره	ل غير ه
لفئات	لفئات لفئات
لفائدة	ل فائدة
لفاجبايى	ل فاجبايي
لفاجبايي	ل فاجبايي
لفترات	ل فترات
لفترة	ل فترة
لفحص	ل فحص
لفراغ	ل فراغ
لفرانس	ل فرانس
لفرانك	لفرانك لفرانك
لفرد	ل فرد
لفرض	ل فرض
لفرنسا	ل فرنسا
لفشل	ل فشل
لفصل	ل فصل
لفض	ل فض
لفظتهم	لفظت هم
لفقدانها	ل فقدان ها
لفكرة	ل فكرة
لفيتنام	ل فيتنام
لقاءاته	لقاءات ه
لقاءه	لقاء ه
لقائه	لقاء ه
لقائهما	لقاء هما
لقادة	ل قادة
لقانون	ل قانون
لقبرص	لقبرص لقبرص
لقبول	ل قبول
لقتال	ل قتال
لقد	ل قد
لقدرة	ل قدرة
لقدرتنا	لقدرتنا لقدرتنا لقدرتنا
لقدرته	ل قدرة ه
لقرار	ل قرار
لقرارات	ل قرارات
لقروض	لقروض لقروض
لقرى	ل قرى
لقرية	لقرية لقرية
لقصف	ل قصف
لقصور	ل قصور
لقضاء	ل قضاء
لقضائه	ل قضاء ه
لقطاع	ل قطاع
لقطاعات	ل قطاعات
لقطر	ل قطر
لقطع	ل قطع
لقـــطاع	ل قطاع
لقمة	ل قمة
لقناة	ل قناة
لقوات	ل قوات
لقواتها	ل قوات ها
لقواعد	ل قواعد
لقوانين	ل قوانين
لقوة	ل قوة
لقوته	ل قوة ه
لقوى	ل قوى
لقيادة	ل قيادة
لقياس	ل قياس
لقيام	ل قيام
لك	ل ك
لكافة	ل كافة
لكان	ل كان
لكانت	ل كانت
لكبار	لكبار لكبار
لكتاب	ل كتاب
لكتب	ل كتب
لكثير	ل كثير
لكرة	ل كرة
لكريستي	ل كريستي
لكسب	ل كسب
لكسر	ل كسر
لكل	ل كل
لكلفته	ل كلفة ه
لكلية	لكلية لكلية
لكم	ل كم
لكمية	ل كمية
لكمين	ل كمين
لكننا	لٰكن نا
لكنني	لكنني لكنني
لكنه	لٰكن ه
لكنها	لٰكن ها
لكنهم	لٰكن هم
لكنهما	لكنهما لكنهما
لكني	لكني لكني
لكهرباء	ل كهرباء
لكوريا	ل كوريا
لكون	ل كون
لكونها	ل كون ها
لكينيا	ل كينيا
للآثار	ل الآثار
للآليات	ل الآليات
للأبحاث	ل الأبحاث
للأجانب	ل الأجانب
للأجور	ل الأجور
للأحزاب	ل الأحزاب
للأحكام	ل الأحكام
للأديب	ل الأديب
للأردن	ل الأردن
للأرض	ل الأرض
للأركان	ل الأركان
للأسبوع	ل الأسبوع
للأسرة	ل الأسرة
للأسرى	ل الأسرى
للأسعار	ل الأسعار
للأسف	ل الأسف
للأسمدة	ل الأسمدة
للأسمنت	ل الأسمنت
للأسواق	ل الأسواق
للأصدقاء	ل الأصدقاء
للأصول	ل الأصول
للأطفال	ل الأطفال
للأعمال	ل الأعمال
للأغذية	ل الأغذية
للأفراد	ل الأفراد
للأقباط	ل الأقباط
للأقطان	ل الأقطان
للأكاديمية	ل الأكاديمية
للأمانة	ل الأمانة
للأمة	ل الأمة
للأمريكيين	ل الأمريكيين
للأمم	ل الأمم
للأمن	ل الأمن
للأموال	ل الأموال
للأمير	ل الأمير
للأمين	ل الأمين
للأوراق	ل الأوراق
للأوعية	ل الأوعية
للإبقاء	ل الإبقاء
للإجابة	ل الإجابة
للإجراءات	ل الإجراءات
للإحاطة	ل الإحاطة
للإحجام	ل الإحجام
للإحصائيات	ل الإحصائيات
للإخوان	ل الإخوان
للإذاعة	ل الإذاعة
للإرادة	ل الإرادة
للإردب	ل الأردب
للإرهاب	ل الإرهاب
للإرهابيين	ل الإرهابيين
للإسترليني	ل الإسترليني
للإسراع	ل الإسراع
للإسكان	ل الإسكان
للإسلاميين	ل الإسلاميين
للإصلاح	ل الإصلاح
للإطلاع	ل الاطلاع
للإعلام	ل الإعلام
للإفراج	ل الإفراج
للإنتاج	ل الإنتاج
للإنشاء	ل الإنشاء
للإنشاءات	ل الإنشاءات
للإيجار	ل الإيجار
للابتزاز	ل الابتزاز
للابحاث	ل الأبحاث
للابن	ل الابن
للاتحاد	ل الاتحاد
للاتصال	ل الاتصال
للاتصالات	ل الاتصالات
للاتفاق	ل الاتفاق
للاتفاقية	ل الاتفاقية
للاتهام	ل الاتهام
للاجئين	ل اللاجئين
للاجانب	ل الأجانب
للاجتماع	ل الاجتماع
للاجراء	ل الإجراء
للاحتراف	ل الاحتراف
للاحتفاظ	ل الاحتفاظ
للاحتياجات	ل الاحتياجات
للاختصاص	ل الاختصاص
للاخلال	ل الإخلال
للاخيرة	ل الأخيرة
للادارة	ل الإدارة
للاذاعة	ل الإذاعة
للاراضي	ل الأراضي
للارتباك	ل الارتباك
للاردنيين	ل الأردنيين
للارسال	ل الإرسال
للارقام	ل الأرقام
للارهاب	ل الإرهاب
للاستئجار	ل الاستئجار
للاستثمار	ل الاستثمار
للاستثمارات	ل الاستثمارات
للاستجابة	ل الاستجابة
للاستخدام	ل الاستخدام
للاستدانة	ل الاستدانة
للاستفادة	ل الاستفادة
للاستفحال	ل الاستفحال
للاستماع	ل الاستماع
للاستمتاع	ل الاستمتاع
للاستمرار	ل الاستمرار
للاستهلاك	ل الاستهلاك
للاستيراد	ل الاستيراد
للاسس	ل الأسس
للاسعار	ل الأسعار
للاسكان	ل الإسكان
للاسلحة	ل الأسلحة
للاسمدة	ل الأسمدة
للاسهام	ل الإسهام
للاسواق	ل الأسواق
للاسيان	ل الأسيان
للاشتباه	ل الاشتباه
للاشخاص	ل الأشخاص
للاشراف	ل الإشراف
للاشقاء	ل الأشقاء
للاصطدام	ل الاصطدام
للاصلاح	ل الإصلاح
للاضطلاع	ل الاضطلاع
للاطاحة	ل الإطاحة
للاطباء	ل الأطباء
للاطفال	ل الأطفال
للاطلاع	ل الاطلاع
للاطمئنان	ل الاطمئنان
للاعبات	ل لاعبات
للاعتداء	ل الاعتداء
للاعتدال	ل الاعتدال
للاعتراف	ل الاعتراف
للاعتماد	ل الاعتماد
للاعداد	ل الإعداد
للاعصاب	ل الأعصاب
للاعلام	ل الإعلام
للاعلان	ل الإعلان
للاغتصاب	ل الاغتصاب
للافراج	ل الإفراج
للافراد	ل الأفراد
للاقتصاد	ل الاقتصاد
للاقلاع	ل الإقلاع
للاكتتاب	ل الاكتتاب
للالتقاء	ل الالتقاء
للالواح	ل الألواح
للامانة	ل الأمانة
للامراض	ل الأمراض
للامريكيين	ل الأمريكيين
للامكانات	ل الإمكانات
للامم	ل الأمم
للامن	ل الأمن
للامير	ل الأمير
للاميرة	ل الأميرة
للاميركيين	ل الأميركيين
للانباء	ل الأنباء
للانتخابات	ل الانتخابات
للانتصار	ل الانتصار
للانتقاد	ل الانتقاد
للانتقال	ل الانتقال
للانتهاء	ل الانتهاء
للانخراط	ل الانخراط
للانخفاض	ل الانخفاض
للاندماج	ل الاندماج
للانضمام	ل الانضمام
للانفتاح	ل الانفتاح
للانفجار	ل الانفجار
للانفصال	ل الانفصال
للانقاذ	ل الإنقاذ
للانقسام	ل الانقسام
للاولى	ل الأولى
للباب	ل الباب
للبابا	ل البابا
للباقي	ل الباقي
للبترول	ل البترول
للبحث	ل البحث
للبحرية	ل البحرية
للبحرين	ل البحرين
للبدء	ل البدء
للبذل	ل البذل
للبرازيل	ل البرازيل
للبرازيلي	ل البرازيلي
للبرلمان	ل البرلمان
للبرميل	ل البرميل
للبريد	ل البريد
للبضائع	ل البضائع
للبطاطس	ل البطاطس
للبطانيات	ل البطانيات
للبطولة	ل البطولة
للبقاء	ل البقاء
للبلاد	ل البلاد
للبلد	ل البلد
للبلدان	ل البلدان
للبلدة	ل البلدة
للبلدين	ل البلدين
للبناء	ل البناء
للبنان	ل لبنان
للبنك	ل البنك
للبنوك	ل البنوك
للبنين	ل البنين
للبورصات	ل البورصات
للبورصة	ل البورصة
للبوسنه	ل البوسنة
للبوسني	ل البوسني
للبويات	للبويات للبويات
للبيئة	ل البيئة
للبيان	ل البيان
للبيع	ل البيع
للتأثير	ل التأثير
للتأكد	ل التأكد
للتأمين	ل التأمين
للتاميل	للتاميل للتاميل
للتبادل	ل التبادل
للتجار	ل التجار
للتجارة	ل التجارة
للتجدد	ل التجدد
للتجديد	ل التجديد
للتجسس	ل التجسس
للتحالف	ل التحالف
للتحديث	ل التحديث
للتحرر	ل التحرر
للتحرك	ل التحرك
للتحضير	ل التحضير
للتحقيق	ل التحقيق
للتحكم	ل التحكم
للتحكيم	ل التحكيم
للتحول	ل التحول
للتحويل	ل التحويل
للتخصيص	ل التخصيص
للتخطيط	ل التخطيط
للتخفيف	ل التخفيف
للتخلص	ل التخلص
للتخلى	ل التخلي
للتداول	ل التداول
للتدخل	ل التدخل
للتدخين	ل التدخين
للتدريب	ل التدريب
للتر	ل لتر
للتراجع	ل التراجع
للتربية	ل التربية
للترددات	ل الترددات
للتركيب	ل التركيب
للترويج	ل الترويج
للتساؤل	ل التساؤل
للتسبيح	ل التسبيح
للتسهيل	ل التسهيل
للتسوية	ل التسوية
للتشاور	ل التشاور
للتشريعات	ل التشريعات
للتشكيل	ل التشكيل
للتشييد	ل التشييد
للتصدير	ل التصدير
للتصديق	ل التصديق
للتصنيع	ل التصنيع
للتضامن	ل التضامن
للتضحية	ل التضحية
للتطبيع	ل التطبيع
للتطبيق	ل التطبيق
للتطورات	ل التطورات
للتطوير	ل التطوير
للتعاطي	ل التعاطي
للتعاقد	ل التعاقد
للتعامل	ل التعامل
للتعاون	ل التعاون
للتعبئة	ل التعبئة
للتعبير	ل التعبير
للتعرف	ل التعرف
للتعريف	ل التعريف
للتعليم	ل التعليم
للتعمير	ل التعمير
للتعهدات	ل التعهدات
للتغلب	ل التغلب
للتـــحيل	ل التحيل
للتفاؤل	ل التفاؤل
للتفاهمات	ل التفاهمات
للتفاوض	ل التفاوض
للتفجير	ل التفجير
للتفكير	ل التفكير
للتقاعد	ل التقاعد
للتقدم	ل التقدم
للتقريب	ل التقريب
للتقنية	ل التقنية
للتكامل	ل التكامل
للتكرير	ل التكرير
للتكنولوجيا	ل التكنولوجيا
للتلفزيون	ل التلفزيون
للتليفزيون	للتليفزيون للتليفزيون
للتمثيل	ل التمثيل
للتمكن	ل التمكن
للتمهيد	ل التمهيد
للتمور	ل التمور
للتمويل	ل التمويل
للتنسيق	ل التنسيق
للتنصت	ل التنصت
للتنظيف	ل التنظيف
للتنظيم	ل التنظيم
للتنظيمات	ل التنظيمات
للتنفيذ	ل التنفيذ
للتنقيب	ل التنقيب
للتنمية	ل التنمية
للتواجد	ل التواجد
للتواصل	ل التواصل
للتوتر	ل التوتر
للتوجه	ل التوجه
للتوريد	ل التوريد
للتوزيع	ل التوزيع
للتوزيعات	ل التوزيعات
للتوصل	ل التوصل
للتوغل	ل التوغل
للتوقف	ل التوقف
للتوقيع	ل التوقيع
للثروات	ل الثروات
للثروة	ل الثروة
للثقة	ل الثقة
للثلاجات	ل الثلاجات
للثور	ل الثور
للثورة	ل الثورة
للثوم	ل الثوم
للجابر	ل الجابر
للجامعة	ل الجامعة
للجانب	ل الجانب
للجانبين	ل الجانبين
للجثتين	ل الجثتين
للجدل	ل الجدل
للجذور	للجذور للجذور
للجري	للجري للجري
للجزائر	ل الجزائر
للجزيرة	ل الجزيرة
للجم	ل لجم
للجمارك	ل الجمارك
للجماعة	ل الجماعة
للجمعية	ل الجمعية
للجمهورية	ل الجمهورية
للجمهوريين	ل الجمهوريين
للجميع	ل الجميع
للجناح	ل الجناح
للجنة	ل لجنة
للجنود	ل الجنود
للجنيه	ل الجنيه
للجهات	ل الجهات
للجواسيس	ل الجواسيس
للجيش	ل الجيش
للحؤول	ل الحؤول
للحاخام	ل الحاخام
للحاصلات	للحاصلات للحاصلات
للحج	ل الحج
للحد	ل الحد
للحدود	ل الحدود
للحديث	ل الحديث
للحديد	ل الحديد
للحرب	ل الحرب
للحرس	ل الحرس
للحركات	ل الحركات
للحركة	ل الحركة
للحرم	ل الحرم
للحريات	ل الحريات
للحريري	ل الحريري
للحزب	ل الحزب
للحصص	ل الحصص
للحصول	ل الحصول
للحضارة	ل الحضارة
للحضور	ل الحضور
للحظر	ل الحظر
للحفارات	ل الحفارات
للحفاظ	ل الحفاظ
للحفر	ل الحفر
للحق	ل الحق
للحقيقة	ل الحقيقة
للحكومة	ل الحكومة
للحل	ل الحل
للحلفاء	ل الحلفاء
للحلويات	ل الحلويات
للحماية	ل الحماية
للحملة	ل الحملة
للحوار	ل الحوار
للحياة	ل الحياة
للحيلولة	ل الحيلولة
للخارج	ل الخارج
للخامات	ل الخامات
للخدمات	ل الخدمات
للخرطوم	ل الخرطوم
للخروج	ل الخروج
للخسائر	ل الخسائر
للخصمين	ل الخصمين
للخطابات	ل الخطابات
للخطة	ل الخطة
للخطر	ل الخطر
للخطوات	ل الخطوات
للخطوط	ل الخطوط
للخلاص	ل الخلاص
للخيار	ل الخيار
للخيول	ل الخيول
للداخل	ل الداخل
للدخل	ل الدخل
للدخول	ل الدخول
للدراسات	ل الدراسات
للدروس	ل الدروس
للدعوة	ل الدعوة
للدفاع	ل الدفاع
للدقة	ل الدقة
للدكتور	ل الدكتور
للدمار	ل الدمار
للدهانات	ل الدهانات
للدهشة	ل الدهشة
للدول	ل الدول
للدولار	ل الدولار
للدولة	ل الدولة
للدولتين	ل الدولتين
للديانات	ل الديانات
للديمقراطية	ل الديمقراطية
للدين	ل الدين
للديون	ل الديون
للذات	ل الذات
للذة	ل لذة
للذهب	ل الذهب
للذوق	ل الذوق
للذين	ل الذين
للرأى	ل الرأي
للرأي	ل الرأي
للرئاسة	ل الرئاسة
للرئيس	ل الرئيس
للراديكاليين	ل الراديكاليين
للراديو	ل الراديو
للراليات	ل الراليات
للرجال	ل الرجال
للرجوع	ل الرجوع
للرد	ل الرد
للرسائل	ل الرسائل
للرسام	ل الرسام
للرضوخ	ل الرضوخ
للرقابة	ل الرقابة
للرهان	ل الرهان
للروائي	ل الروائي
للروس	ل الروس
للرياضيين	ل الرياضيين
للزراعة	ل الزراعة
للزعيم	ل الزعيم
للزيادة	ل الزيادة
للزيارات	ل الزيارات
للزيارة	ل الزيارة
للسائحين	ل السائحين
للسارس	ل السارس
للسامية	ل السامية
للسبب	ل السبب
للسداد	ل السداد
للسعودية	ل السعودية
للسعوديين	ل السعوديين
للسفارة	ل السفارة
للسفر	ل السفر
للسفينة	ل السفينة
للسقوط	ل السقوط
للسكان	ل السكان
للسكك	ل السكك
للسلاح	ل السلاح
للسلام	ل السلام
للسلطات	ل السلطات
للسلطة	ل السلطة
للسلع	ل السلع
للسلوك	ل السلوك
للسماح	ل السماح
للسمعة	ل السمعة
للسمك	ل السمك
للسنة	ل السنة
للسنوات	ل السنوات
للسودانيين	ل السودانيين
للسوق	ل السوق
للسويسريين	ل السويسريين
للسياحة	ل السياحة
للسيادة	ل السيادة
للسيارات	ل السيارات
للسياسات	ل السياسات
للسياسة	ل السياسة
للسياسية	ل السياسية
للسياسيين	ل السياسيين
للسيدات	ل السيدات
للسيطرة	ل السيطرة
للسيولة	ل السيولة
للشأن	ل الشأن
للشؤون	ل الشؤون
للشئون	ل الشؤون
للشباب	ل الشباب
للشبكة	ل الشبكة
للشحن	ل الشحن
للشحنة	ل الشحنة
للشخص	ل الشخص
للشراء	ل الشراء
للشراكة	ل الشراكة
للشرب	ل الشرب
للشرطة	ل الشرطة
للشرعية	ل الشرعية
للشرق	ل الشرق
للشركات	ل الشركات
للشركة	ل الشركة
للشركتين	ل الشركتين
للشروط	ل الشروط
للشريعة	ل الشريعة
للشطرنج	ل الشطرنج
للشعارات	ل الشعارات
للشعب	ل الشعب
للشعبين	ل الشعبين
للشغب	ل الشغب
للشفاء	ل الشفاء
للشقق	ل الشقق
للشلل	ل الشلل
للشيشان	ل الشيشان
للشيعة	ل الشيعة
للصاج	ل الصاج
للصادرات	ل الصادرات
للصحافة	ل الصحافة
للصحافيين	ل الصحافيين
للصحة	ل الصحة
للصحفيين	ل الصحفيين
للصراع	ل الصراع
للصراعات	ل الصراعات
للصرافة	ل الصرافة
للصرف	ل الصرف
للصلاة	ل الصلاة
للصلب	ل الصلب
للصناعات	ل الصناعات
للصناعة	ل الصناعة
للصندوق	ل الصندوق
للصوامع	ل الصوامع
للصوص	ل اللصوص
للصيارفة	ل الصيارفة
للصيانة	ل الصيانة
للصين	ل الصين
للضائقة	ل الضائقة
للضرائب	ل الضرائب
للضرب	ل الضرب
للضربات	ل الضربات
للضرورة	ل الضرورة
للضعف	ل الضعف
للضغط	ل الضغط
للضغوط	ل الضغوط
للطائرات	ل الطائرات
للطائرة	ل الطائرة
للطاقات	ل الطاقات
للطاقة	ل الطاقة
للطالباني	ل الطالباني
للطب	ل الطب
للطبقات	ل الطبقات
للطبقة	ل الطبقة
للطرفين	ل الطرفين
للطرق	ل الطرق
للطريقة	ل الطريقة
للطفولة	ل الطفولة
للطلاب	ل الطلاب
للطلاق	ل الطلاق
للطلب	ل الطلب
للطن	ل الطن
للطوربيدات	ل الطوربيدات
للطيران	ل الطيران
للعائلات	ل العائلات
للعائلة	ل العائلة
للعادي	ل العادي
للعاصمة	ل العاصمة
للعافية	ل العافية
للعالم	ل العالم
للعالمين	ل العالمين
للعام	ل العام
للعاملين	ل العاملين
للعب	ل اللعب
للعبة	ل اللعبة
للعدالة	ل العدالة
للعدوان	ل العدوان
للعديد	ل العديد
للعراق	ل العراق
للعراقيين	ل العراقيين
للعرب	ل العرب
للعرض	ل العرض
للعروبة	ل العروبة
للعروض	ل العروض
للعقارات	ل العقارات
للعقد	ل العقد
للعقلية	ل العقلية
للعقوبات	ل العقوبات
للعقود	ل العقود
للعلاج	ل العلاج
للعلاقات	ل العلاقات
للعلاقة	ل العلاقة
للعلب	ل العلب
للعلماء	ل العلماء
للعلوم	ل العلوم
للعمال	ل العمال
للعمالة	ل العمالة
للعمل	ل العمل
للعملاء	ل العملاء
للعملات	ل العملات
للعملة	ل العملة
للعموم	ل العموم
للعنف	ل العنف
للعهدين	ل العهدين
للعودة	ل العودة
للعيون	ل العيون
للغارات	ل الغارات
للغاز	ل الغاز
للغازات	ل الغازات
للغالبية	ل الغالبية
للغاية	ل الغاية
للغذاء	ل الغذاء
للغرب	ل الغرب
للغرفة	ل الغرفة
للغزل	ل الغزل
للغزو	ل الغزو
للغزول	ل الغزول
للغواصة	ل الغواصة
للغوص	ل الغوص
للـنـــفط	ل النفط
للف	ل اللف
للفائدة	ل الفائدة
للفاخر	ل الفاخر
للفاصوليا	للفاصوليا للفاصوليا
للفحم	ل الفحم
للفروسية	ل الفروسية
للفريق	ل الفريق
للفساد	ل الفساد
للفسق	ل الفسق
للفصائل	ل الفصائل
للفكر	ل الفكر
للفلاحة	ل الفلاحة
للفلاحين	ل الفلاحين
للفلسطينيين	ل الفلسطينيين
للفنادق	ل الفنادق
للفوز	ل الفوز
للفوسفات	ل الفوسفات
للفيدرالية	ل الفيدرالية
للقاء	ل لقاء
للقائم	ل القائم
للقارة	ل القارة
للقانون	ل القانون
للقاهرة	ل القاهرة
للقبارصة	ل القبارصة
للقبض	ل القبض
للقبـــيلة	ل القبيلة
للقدرة	ل القدرة
للقدس	ل القدس
للقديس	ل القديس
للقرار	ل القرار
للقرن	ل القرن
للقروض	ل القروض
للقرويين	ل القرويين
للقصة	ل القصة
للقضاء	ل القضاء
للقضية	ل القضية
للقطاع	ل القطاع
للقطاعات	ل القطاعات
للقطن	ل القطن
للقلق	ل القلق
للقمة	ل القمة
للقمح	ل القمح
للقوات	ل القوات
للقواعد	ل القواعد
للقوة	ل القوة
للقومية	ل القومية
للقوى	ل القوى
للقيام	ل القيام
للقيم	ل القيم
للقيمة	ل القيمة
للكتاب	ل الكتاب
للكتب	ل الكتب
للكثيرين	ل الكثيرين
للكشف	ل الكشف
للكنيست	ل الكنيست
للكهرباء	ل الكهرباء
للكوريين	ل الكوريين
للكوكايين	ل الكوكايين
للكونغو	ل الكونغو
للكونكاكاف	للكونكاكاف للكونكاكاف
للكويت	ل الكويت
للمؤتمر	ل المؤتمر
للمؤسسات	ل المؤسسات
للمؤسسة	ل المؤسسة
للماء	ل الماء
للماس	ل الماس
للمال	ل المال
للمبادئ	ل المبادئ
للمباراة	ل المباراة
للمباني	ل المباني
للمتابعة	ل المتابعة
للمتوسط	ل المتوسط
للمثقفين	ل المثقفين
للمجالس	ل المجالس
للمجتمع	ل المجتمع
للمجلس	ل المجلس
للمجموعات	ل المجموعات
للمجوهرات	ل المجوهرات
للمجيء	ل المجيء
للمحادثات	ل المحادثات
للمحاسبات	ل المحاسبات
للمحافظات	ل المحافظات
للمحافظة	ل المحافظة
للمحامي	ل المحامي
للمحامين	ل المحامين
للمحتل	ل المحتل
للمحروقات	ل المحروقات
للمحطة	ل المحطة
للمحكمة	ل المحكمة
للمحمول	ل المحمول
للمخابرات	ل المخابرات
للمخازن	ل المخازن
للمخاطر	ل المخاطر
للمخرج	ل المخرج
للمدة	ل المدة
للمدير	ل المدير
للمدينة	ل المدينة
للمذيع	ل المذيع
للمرأة	ل المرأة
للمراجل	ل المراجل
للمرافعة	ل المرافعة
للمراقبين	ل المراقبين
للمراهقات	ل المراهقات
للمراهقين	ل المراهقين
للمراوغة	ل المراوغة
للمرة	ل المرة
للمرحلة	ل المرحلة
للمرشح	ل المرشح
للمرشد	ل المرشد
للمرض	ل المرض
للمرضى	ل المرضى
للمركز	ل المركز
للمركزي	ل المركزي
للمروحيات	ل المروحيات
للمرور	ل المرور
للمريض	ل المريض
للمزارعين	ل المزارعين
للمزايا	ل المزايا
للمسؤول	ل المسؤول
للمسؤولة	ل المسؤولة
للمسؤولية	ل المسؤولية
للمسؤولين	ل المسؤولين
للمسئول	ل المسؤول
للمسئولين	ل المسؤولين
للمساعدة	ل المساعدة
للمسافرين	ل المسافرين
للمساكن	ل المساكن
للمساهمة	ل المساهمة
للمساهمين	ل المساهمين
للمساواة	ل المساواة
للمستثمر	ل المستثمر
للمستثمرين	ل المستثمرين
للمستشفيات	ل المستشفيات
للمستلزمات	ل المستلزمات
للمستندات	ل المستندات
للمستهلك	ل المستهلك
للمستوردين	ل المستوردين
للمسجد	ل المسجد
للمسلحين	ل المسلحين
للمسلمين	ل المسلمين
للمسنين	ل المسنين
للمسيح	ل المسيح
للمسيحية	ل المسيحية
للمسيحيين	ل المسيحيين
للمشاركة	ل المشاركة
للمشاريع	ل المشاريع
للمشروبات	ل المشروبات
للمشروع	ل المشروع
للمشروعات	ل المشروعات
للمشكلات	ل المشكلات
للمشكلة	ل المشكلة
للمصابين	ل المصابين
للمصادمات	ل المصادمات
للمصارف	ل المصارف
للمصانع	ل المصانع
للمصدر	ل المصدر
للمصدرين	ل المصدرين
للمصرف	ل المصرف
للمصريين	ل المصريين
للمضاربة	ل المضاربة
للمضخات	ل المضخات
للمضي	ل المضي
للمطارات	ل المطارات
للمعابد	ل المعابد
للمعادن	ل المعادن
للمعارضة	ل المعارضة
للمعارف	ل المعارف
للمعالجة	ل المعالجة
للمعاملات	ل المعاملات
للمعركة	ل المعركة
للمعطيات	ل المعطيات
للمعلومات	ل المعلومات
للمغرب	ل المغرب
للمفاوض	ل المفاوض
للمفاوضات	ل المفاوضات
للمفاوضة	ل المفاوضة
للمفتــشين	ل المفتشين
للمفوض	ل المفوض
للمقاصد	ل المقاصد
للمقاطعات	ل المقاطعات
للمقاولات	ل المقاولات
للمقاولين	ل المقاولين
للمقاومة	ل المقاومة
للمكانس	ل المكانس
للمكسيك	ل المكسيك
للملابس	ل الملابس
للملك	ل الملك
للممارسات	ل الممارسات
للممثلين	ل الممثلين
للمملكة	ل المملكة
للمناخ	ل المناخ
للمنازل	ل المنازل
للمنافسة	ل المنافسة
للمناقشة	ل المناقشة
للمنتج	ل المنتج
للمنتجات	ل المنتجات
للمنتجين	ل المنتجين
للمنتخب	ل المنتخب
للمنتوج	ل المنتوج
للمندوبين	ل المندوبين
للمنسق	ل المنسق
للمنسوجات	ل المنسوجات
للمنشآت	ل المنشآت
للمنطقة	ل المنطقة
للمنظمة	ل المنظمة
للمهمة	ل المهمة
للمواجهة	ل المواجهة
للمواد	ل المواد
للموارد	ل الموارد
للموازنة	ل الموازنة
للمواصفات	ل المواصفات
للمواطن	ل المواطن
للمواطنين	ل المواطنين
للموافقة	ل الموافقة
للموساد	للموساد للموساد
للموضوعية	ل الموضوعية
للموعد	ل الموعد
للموقف	ل الموقف
للنائب	ل النائب
للناتو	للناتو للناتو
للنادي	ل النادي
للناس	ل الناس
للناشئين	ل الناشئين
للنزاع	ل النزاع
للنساء	ل النساء
للنشاط	ل النشاط
للنشر	ل النشر
للنظام	ل النظام
للنظر	ل النظر
للنظم	ل النظم
للنفط	ل النفط
للنفوذ	ل النفوذ
للنقاش	ل النقاش
للنقال	ل النقال
للنقل	ل النقل
للنمو	ل النمو
للنهب	ل النهب
للنهوض	ل النهوض
للنيابة	ل النيابة
لله	ل اللٰه
للهاتف	ل الهاتف
للهجمات	ل الهجمات
للهجوم	ل الهجوم
للهدف	ل الهدف
للهزيمة	ل الهزيمة
للهند	ل الهند
للهوكى	للهوكى للهوكى
للهيئة	ل الهيئة
للهيمنة	ل الهيمنة
للواردات	ل الواردات
للواقعة	ل الواقعة
للوبي	ل اللوبي
للوجود	ل الوجود
للوحدة	ل الوحدة
للورق	ل الورق
للوزارة	ل الوزارة
للوزراء	ل الوزراء
للوزير	ل الوزير
للوصول	ل الوصول
للوضع	ل الوضع
للوطن	ل الوطن
للوفاء	ل الوفاء
للوفاق	ل الوفاق
للوقاية	ل الوقاية
للوقت	ل الوقت
للوقوف	ل الوقوف
للولايات	ل الولايات
لليخوت	ل اليخوت
لليد	ل اليد
لليكود	ل ليكود
لليمن	ل اليمن
لليهود	ل اليهود
لليورو	ل اليورو
لليوم	ل اليوم
لمؤتمر	ل مؤتمر
لمؤسسة	ل مؤسسة
لما	ل ما
لماذا	ل ماذا
لماكينات	ل ماكينات
لمبادرة	ل مبادرة
لمباريات	ل مباريات
لمباشرة	ل مباشرة
لمبدأ	ل مبدإ
لمبنى	لمبنى لمبنى
لمتأخراتها	ل متأخرات ها
لمتابعة	ل متابعة
لمتحدثة	ل متحدثة
لمترو	لمترو لمترو
لمتطلبات	ل متطلبات
لمتغيرات	ل متغيرات
لمثل	ل مثل
لمجرد	ل مجرد
لمجلة	ل مجلة
لمجلس	ل مجلس
لمجلسي	ل مجلسي
لمجموعة	ل مجموعة
لمحاسبة	ل محاسبة
لمحافظة	ل محافظة
لمحاولة	ل محاولة
لمحتشمي	لمحتشمي لمحتشمي
لمحدودي	ل محدودي
لمحمد	لمحمد لمحمد
لمحن	ل محن
لمحو	ل محو
لمخاطر	ل مخاطر
لمخافر	لمخافر لمخافر
لمدافع	ل مدافع
لمدة	ل مدة
لمدد	ل مدد
لمدراء	ل مدراء
لمدرب	ل مدرب
لمديرية	ل مديرية
لمدينة	ل مدينة
لمراجعة	ل مراجعة
لمراجعيها	ل مراجعي ها
لمراسل	ل مراسل
لمراعاة	ل مراعاة
لمرافقته	ل مرافقة ه
لمراقبة	ل مراقبة
لمراكز	ل مراكز
لمرحلة	ل مرحلة
لمرسليهم	ل مرسلي هم
لمرضى	ل مرضى
لمركز	ل مركز
لمرور	ل مرور
لمزيد	ل مزيد
لمسؤولين	ل مسؤولين
لمسابقتي	ل مسابقتي
لمساته	لمسات ه
لمساعدة	ل مساعدة
لمساعدتهم	ل مساعدة هم
لمسافر	ل مسافر
لمساكن	ل مساكن
لمساندة	ل مساندة
لمستثمر	ل مستثمر
لمستحقيها	ل مستحقي ها
لمستشفى	ل مستشفى
لمستقبل	ل مستقبل
لمستندات	ل مستندات
لمستوى	ل مستوى
لمستويات	ل مستويات
لمسلسل	ل مسلسل
لمسودة	ل مسودة
لمسيرة	ل مسيرة
لمشاركة	ل مشاركة
لمشاركين	ل مشاركين
لمشاريع	ل مشاريع
لمشاعر	ل مشاعر
لمشاغل	لمشاغل لمشاغل
لمشاكلهم	ل مشاكل هم
لمشتري	ل مشتري
لمشتقات	ل مشتقات
لمشروع	ل مشروع
لمشكلات	ل مشكلات
لمشكلة	ل مشكلة
لمصادر	ل مصادر
لمصانع	ل مصانع
لمصر	ل مصر
لمصلحة	ل مصلحة
لمصلحته	ل مصلحة ه
لمصنعي	ل مصنعي
لمطار	ل مطار
لمطالب	ل مطالب
لمطالبه	ل مطالب ه
لمطالبهم	ل مطالب هم
لمعاداة	ل معاداة
لمعالجة	ل معالجة
لمعالجته	ل معالجة ه
لمعاملة	ل معاملة
لمعاني	ل معاني
لمعاودة	ل معاودة
لمعدات	ل معدات
لمعرفة	ل معرفة
لمعظم	ل معظم
لمعلومات	ل معلومات
لمعهد	ل معهد
لمفاعلها	ل مفاعل ها
لمفاوضات	ل مفاوضات
لمفاوضته	ل مفاوضة ه
لمفردات	ل مفردات
لمقابلة	ل مقابلة
لمقاطعة	ل مقاطعة
لمقومات	ل مقومات
لمكافحة	ل مكافحة
لمكتب	ل مكتب
لمكتبي	لمكتبي لمكتبي لمكتبي
لممارسات	ل ممارسات
لممارسة	ل ممارسة
لممثلي	ل ممثلي
لممثلين	ل ممثلين
لمن	ل من
لمناسبة	ل مناسبة
لمناطق	ل مناطق
لمناقشات	ل مناقشات
لمناقشة	ل مناقشة
لمناهضة	ل مناهضة
لمنتجات	ل منتجات
لمنتجاتهم	ل منتجات هم
لمنتجي	ل منتجي
لمنح	ل منح
لمندوب	ل مندوب
لمنزل	لمنزل لمنزل
لمنسوباتها	ل منسوبات ها
لمنشآته	ل منشآت ه
لمنصبه	ل منصب ه
لمنطقة	ل منطقة
لمنظمات	ل منظمات
لمنظمة	ل منظمة
لمنع	ل منع
لمنعهم	ل منع هم
لمهاجمة	ل مهاجمة
لمهاجمتنا	لمهاجمتنا لمهاجمتنا لمهاجمتنا
لمهرجان	ل مهرجان
لمواجهة	ل مواجهة
لمواجهتها	ل مواجهة ها
لموارد	ل موارد
لموازنة	ل موازنة
لمواصلة	ل مواصلة
لمواطني	ل مواطني
لمواطنيها	ل مواطني ها
لمواقع	ل مواقع
لمواقعهم	ل مواقع هم
لمواقف	ل مواقف
لمواكبة	ل مواكبة
لموسكو	ل موسكو
لموسم	ل موسم
لموسمين	ل موسمين
لموسى	لموسى لموسى
لموسيقى	لموسيقى لموسيقى
لموظفي	ل موظفي
لموظفيها	ل موظفي ها
لموعد	لموعد لموعد
لموقع	لموقع لموقع
لموقف	ل موقف
لموقفها	ل موقف ها
لمونديال	لمونديال لمونديال
لنا	لنا لنا
لنائبين	ل نائبين
لنبوءات	لنبوءات لنبوءات
لنتجاوز	لنتجاوز لنتجاوز
لنجاح	ل نجاح
لنحو	ل نحو
لنرى	لنرى لنرى
لنزاع	ل نزاع
لنزع	لنزع لنزع
لنسبة	ل نسبة
لنستمر	لنستمر لنستمر
لنشر	ل نشر
لنص	ل نص
لنصر	لنصر لنصر
لنطلب	لنطلب لنطلب
لنطلق	ل نطلق
لنظام	ل نظام
لنظرية	ل نظرية
لنفس	ل نفس
لنفسه	ل نفس ه
لنفسها	ل نفس ها
لنفط	ل نفط
لنفوذهما	ل نفوذ هما
لنقطة	ل نقطة
لنقل	ل نقل
لنقلهم	ل نقل هم
لنمو	ل نمو
لنهائيات	ل نهائيات
لنهر	ل نهر
لنواب	ل نواب
لنيوز	ل نيوز
له	ل ه
لهؤلاء	ل هٰؤلاء
لها	ل ها
لهجته	لهجة ه
لهجمات	ل هجمات
لهجوم	ل هجوم
لهذا	ل هٰذا
لهذه	ل هٰذه
لهزة	ل هزة
لهزيمة	ل هزيمة
لهــذه	ل هٰذه
لهم	ل هم
لهما	ل هما
لهونج	ل هونج
لهونغ	ل هونغ
لهويتنا	لهويتنا لهويتنا لهويتنا
لهيئة	ل هيئة
لهيكل	ل هيكل
لواردات	ل واردات
لواشنطن	ل واشنطن
لوالده	ل والد ه
لوجه	ل وجه
لوجهة	ل وجهة
لوجود	ل وجود
لوحدات	ل وحدات
لوحدها	ل وحد ها
لورثتها	ل ورثة ها
لوزارة	ل وزارة
لوزراء	ل وزراء
لوزير	ل وزير
لوزيري	ل وزيري
لوسائل	ل وسائل
لوساطته	ل وساطة ه
لوضع	ل وضع
لوضعها	ل وضع ها
لوطننا	لوطننا لوطننا لوطننا
لوظائفها	ل وظائف ها
لوفاة	لوفاة لوفاة
لوقائع	ل وقائع
لوقف	ل وقف
لوقفها	ل وقف ها
لوقود	ل وقود
لوقوع	ل وقوع
لوكالة	ل وكالة
لولايات	ل ولايات
لولي	ل ولي
ليؤكد	ل يؤكد
لياسر	لياسر لياسر
لياقتي	لياقة ي
ليبلغ	ل يبلغ
ليتجاوز	ل يتجاوز
ليتراجع	ل يتراجع
ليتراوح	ل يتراوح
ليتعاملوا	ل يتعاملوا
ليتم	ل يتم
ليتمكنوا	ل يتمكنوا
ليتولى	ل يتولى
ليثبتوا	ل يثبتوا
ليجبر	ل يجبر
ليجبرها	ل يجبر ها
ليحافظوا	ل يحافظوا
ليحدد	ل يحدد
ليحقق	ل يحقق
ليدرسوا	ل يدرسوا
ليرتفع	ل يرتفع
ليرحّب	ل يرحب
ليرد	ل يرد
ليرفع	ل يرفع
ليستأنف	ل يستأنف
ليستخدم	ل يستخدم
ليسجل	ل يسجل
ليسرى	ليسرى ليسرى
ليسلم	ل يسلم
ليسلموه	ل يسلموا ه
ليشرف	ل يشرف
ليشمل	ل يشمل
ليصل	ل يصل
ليصوب	ل يصوب
ليضع	ل يضع
ليطلبوا	ل يطلبوا
ليعيشوا	ل يعيشوا
ليفحص	ل يفحص
ليقترب	ل يقترب
ليكون	ل يكون
ليكونا	ل يكونا
ليلته	ليلة ه
ليلفظ	ل يلفظ
ليمر	ل يمر
لينضم	ل ينضم
ليوم	ل يوم
ليومين	ل يومين
مآذنها	مآذن ها
مؤازرته	مؤازرة ه
مؤتمره	مؤتمر ه
مؤتمرهم	مؤتمر هم
مؤسسوها	مؤسسو ها
مؤلفيها	مؤلفي ها
ماأصبحت	ما أصبحت
مادام	ما دام
مارستها	مارست ها
مارسها	مارس ها
مازال	ما زال
مازالت	ما زالت
ماسورته	ماسورة ه
مالها	مال ها
ماهيتها	ماهية ها
مباحثاته	مباحثات ه
مباحثاتهما	مباحثات هما
مبادئنا	مبادئنا مبادئنا
مبادئها	مبادئ ها
مبارياتها	مباريات ها
مبانيها	مباني ها
مبدئها	مبدإ ها
متنها	متن ها
متنهما	متنهما متنهما
مثاله	مثال ه
مثلما	مثل ما
مثله	مثل ه
مثيله	مثيل ه
مجاريها	مجاري ها
مجاله	مجال ه
مجالها	مجالها مجالها
مجمله	مجمل ه
مجملها	مجمل ها
مجموعاتها	مجموعات ها
مجموعته	مجموعة ه
مجموعه	مجموع ه
محادثاته	محادثات ه
محادثاتهم	محادثات هم
محادثتهما	محادثتهما محادثتهما
محاصرته	محاصرة ه
محاصرتها	محاصرة ها
محاصرتهم	محاصرة هم
محاكمته	محاكمته محاكمته
محاكمتهم	محاكمة هم
محامي	محامي ي
محاميه	محامي ه
محاولته	محاولة ه
محتواها	محتوى ها
محتوياتها	محتويات ها
محفظتها	محفظة ها
محفور	محفور علي ها
محققيه	محققي ه
محله	محل ه
محلها	محل ها
محنته	محنة ه
محنتها	محنة ها
محيطه	محيط ه
مخابراتها	مخابرات ها
مخازنها	مخازن ها
مخاطرها	مخاطر ها
مخصصاتها	مخصصات ها
مخططهم	مخططهم مخططهم
مخيلاتهم	مخيلات هم
مدارسهم	مدارس هم
مداه	مدى ه
مدته	مدة ه
مدتها	مدة ها
مدخراتهم	مدخرات هم
مدربه	مدرب ه
مدربها	مدرب ها
مديروها	مديرو ها
مدينتهم	مدينة هم
مديونياتها	مديونيات ها
مذكراته	مذكرات ه
مراحله	مراحل ه
مراحلها	مراحل ها
مراسيها	مراسي ها
مرافقته	مرافقته مرافقته
مرافقيه	مرافقي ه
مراكزها	مراكز ها
مرتبتها	مرتبة ها
مرحلته	مرحلة ه
مرده	مرد ه
مردوده	مردود ه
مردودها	مردود ها
مرشدها	مرشد ها
مركزك	مركز ك
مركزها	مركز ها
مركزهم	مركز هم
مركزيهما	مركزيهما مركزيهما
مروحياته	مروحيات ه
مرورها	مرور ها
مزادها	مزاد ها
مزقتها	مزقت ها
مسؤولياتنا	مسؤولياتنا مسؤولياتنا
مسؤوليته	مسؤولية ه
مسؤوليتها	مسؤوليتها مسؤوليتها
مسؤوليها	مسؤولي ها
مسئولياتك	مسؤوليات ك
مسئولياتها	مسؤوليات ها
مسئوليته	مسؤولية ه
مسئوليتها	مسؤولية ها
مساحتها	مساحة ها
مساعدته	مساعدته مساعدته
مساعدتها	مساعدتها مساعدتها
مساعده	مساعد ه
مساعديه	مساعدي ه
مساعيه	مساعي ه
مساعيها	مساعي ها
مساندتهم	مساندة هم
مستثمريها	مستثمري ها
مستحقاتها	مستحقات ها
مستقبلك	مستقبل ك
مستقبله	مستقبل ه
مستقبلهم	مستقبل هم
مستقبليه	مستقبلي ه
مستلزماته	مستلزمات ه
مستواه	مستوى ه
مستواها	مستوى ها
مستواي	مستوى ي
مستوياته	مستويات ه
مستوياتها	مستويات ها
مستوياتهم	مستوياتهم مستوياتهم
مسعاهم	مسعى هم
مسمياتها	مسميات ها
مسيرته	مسيرة ه
مسيرتها	مسيرة ها
مشاركته	مشاركة ه
مشاركتها	مشاركة ها
مشاركتهم	مشاركة هم
مشاركتي	مشاركة ي
مشاريعهم	مشاريع هم
مشاعرك	مشاعر ك
مشاكلها	مشاكل ها
مشروعاتك	مشروعات ك
مشروعه	مشروع ه
مشروعها	مشروعها مشروعها
مشكلتنا	مشكلتنا مشكلتنا
مشورته	مشورة ه
مصادره	مصادر ه
مصادرها	مصادر ها
مصالحها	مصالح ها
مصالحهم	مصالحهم مصالحهم
مصانعها	مصانع ها
مصداقيتها	مصداقية ها
مصدرها	مصدر ها
مصراعيه	مصراعي ه
مصرعهم	مصرع هم
مصرعهما	مصرع هما
مصطلحاته	مصطلحات ه
مصلحتنا	مصلحتنا مصلحتنا
مصلحتها	مصلحة ها
مصيره	مصير ه
مصيرها	مصير ها
مصيرهم	مصير هم
مضمونها	مضمون ها
مطالبته	مطالبة ه
مطالبتها	مطالبة ها
مطالبه	مطالب ه
مطلبهم	مطلب هم
مظاهره	مظاهر ه
مظهره	مظهر ه
مظهرهم	مظهر هم
معاداتها	معاداة ها
معارضته	معارضة ه
معارضتها	معارضة ها
معارضيه	معارضي ه
معارفه	معارفه معارفه
معاركها	معارك ها
معالمه	معالم ه
معاملته	معاملة ه
معانيه	معاني ه
معاونها	معاون ها
معتقداتها	معتقدات ها
معتقله	معتقل ه
معدلاتها	معدلات ها
معدنها	معدن ها
معركتها	معركة ها
معسكراتها	معسكرات ها
معسكرهم	معسكر هم
معظمها	معظم ها
معظمهم	معظم هم
معك	مع ك
معنا	معنا معنا
معناه	معنى ه
معناها	معنى ها
معنوياته	معنويات ه
معنوياتهم	معنويات هم
معه	مع ه
معها	مع ها
معهم	مع هم
معهما	معهما معهما
معي	معي معي
مغادرته	مغادرة ه
مغادرتها	مغادرة ها
مغادرتهم	مغادرة هم
مغزاهــا	مغزى ها
مفاتيحه	مفاتيحه مفاتيحه
مفادها	مفاد ها
مفاوضاته	مفاوضات ه
مفوضها	مفوضها مفوضها
مقابلتهم	مقابلة هم
مقاتليه	مقاتلي ه
مقاطعتنا	مقاطعتنا مقاطعتنا
مقاعده	مقاعد ه
مقايضتها	مقايضة ها
مقترحاته	مقترحات ه
مقترحاتهما	مقترحاتهما مقترحاتهما
مقتله	مقتل ه
مقدارها	مقدار ها
مقدمته	مقدمة ه
مقدمتها	مقدمة ها
مقدمها	مقدم ها
مقدمهم	مقدم هم
مقره	مقر ه
مقرها	مقر ها
مقصوراتها	مقصورات ها
مكاسبهم	مكاسب هم
مكافأته	مكافأة ه
مكانته	مكانة ه
مكانه	مكان ه
مكانها	مكان ها
مكتبه	مكتب ه
مكـــنهم	مكن هم
مكلّفهم	مكلفهم مكلفهم
مكنتهم	مكنت هم
مكنني	مكنني مكنني
ملابسه	ملابس ه
ملابسهم	ملابس هم
ملاحظاته	ملاحظات ه
ملامحها	ملامح ها
ملفاتها	ملفات ها
ملفها	ملف ها
ملكــــيتها	ملكية ها
ملكي	ملكي ملكي
ملكيتها	ملكية ها
مما	من ما
ممتلكاته	ممتلكات ه
ممتلكاتهم	ممتلكات هم
ممثليه	ممثلي ه
ممن	من من
منا	منا منا
منازلهم	منازل هم
مناصريه	مناصري ه
مناطقهم	مناطق هم
منافسيها	منافسي ها
مناقشاتها	مناقشات ها
مناقشته	مناقشة ه
مناقشتها	مناقشة ها
منتجاته	منتجات ه
منتجاتها	منتجات ها
منتجاتهم	منتجات هم
منتجاتهما	منتجات هما
منتقديه	منتقدي ه
منحتها	منحت ها
منحني	منحني منحني
منحها	منح ها
منحهم	منح هم
منزله	منزل ه
منزلها	منزل ها
منشآتنا	منشآتنا منشآتنا
منشآتها	منشآت ها
منصبك	منصب ك
منصبه	منصب ه
منطقتنا	منطقتنا منطقتنا
منظمته	منظمة ه
منعتها	منعة ها
منعكم	منع كم
منفاه	منفى ه
منك	من ك
منه	من ه
منها	من ها
منهاجهم	منهاج هم
منهم	من هم
منهما	من هما
منهن	من هن
مني	مني مني
مهاجمته	مهاجمة ه
مهارتهم	مهارة هم
مهامها	مهام ها
مهامهم	مهام هم
مهامهما	مهامهما مهامهما
مهماتها	مهمات ها
مهمتنا	مهمة نا
مهمته	مهمة ه
مهمتها	مهمة ها
مهمتهم	مهمة هم
مواثيقنا	مواثيقنا مواثيقنا
مواجهتها	مواجهة ها
مواده	مواد ه
موارده	موارده موارده
مواردها	موارد ها
موازنتها	موازنة ها
مواطنتها	مواطنة ها
مواطنه	مواطن ه
مواطنيه	مواطني ه
مواطنيها	مواطني ها
موافقته	موافقة ه
موافقتها	موافقة ها
مواقعها	مواقعها مواقعها
مواقعهم	مواقع هم
مواقفنا	مواقفنا مواقفنا
مواقفه	مواقف ه
مواقفهما	مواقفهما مواقفهما
مواليده	مواليد ه
موجوداتها	موجودات ها
مورديها	موردي ها
موضعها	موضع ها
موظفيه	موظفي ه
موظفيها	موظفي ها
موعدها	موعد ها
موقعه	موقع ه
موقعها	موقع ها
موقفك	موقف ك
موقفنا	موقفنا موقفنا
موقفه	موقف ه
موقفها	موقف ها
موقفهم	موقف هم
مولانا	مولانا مولانا
ميزانها	ميزان ها
ميزانيتها	ميزانية ها
ميولهم	ميولهم ميولهم
نؤيدها	نؤيدها نؤيدها
نائبه	نائب ه
ناحيته	ناحية ه
ناخبيهم	ناخبي هم
ناديه	ناديه ناديه
ناقشته	ناقشت ه
نبيعها	نبيعها نبيعها
نتائجه	نتائج ه
نتائجها	نتائج ها
نتوقعه	نتوقعه نتوقعه
نجاحنا	نجاحنا نجاحنا
نجاحه	نجاح ه
نجدها	نجدها نجدها
نجليه	نجلي ه
نجومها	نجوم ها
نحره	نحر ه
ندينه	ندينه ندينه
نذقه	نذقه نذقه
نراها	نراها نراها
نساؤنا	نساء نا
نسبته	نسبة ه
نسبتها	نسبة ها
نستوردها	نستورد ها
نسخه	نسخ ه
نسمعه	نسمعه نسمعه
نشاطه	نشاط ه
نشاطها	نشاط ها
نشاطهم	نشاط هم
نشرتنا	نشرة نا
نشرته	نشرت ه
نشرتها	نشرت ها
نشره	نشر ه
نشرها	نشر ها
نشرهم	نشر هم
نشوبها	نشوب ها
نصبه	نصب ه
نصحه	نصح ه
نصدرها	نصدرها نصدرها
نصفها	نصف ها
نصها	نص ها
نصوصه	نصوص ه
نصيبها	نصيب ها
نضالهن	نضال هن
نظائرها	نظائر ها
نظامه	نظام ه
نظرائه	نظراء ه
نظرائها	نظراء ها
نظرائهم	نظراء هم
نظرتها	نظرة ها
نظرنا	نظرنا نظرنا
نظرها	نظر ها
نظرهم	نظر هم
نظرهن	نظر هن
نظمته	نظمت ه
نظمتها	نظمت ها
نظيرتها	نظيرة ها
نظيره	نظير ه
نظيرها	نظير ها
نعيهم	نعيهم نعيهم
نفاه	نفى ه
نفذتها	نفذت ها
نفذها	نفذ ها
نفسك	نفس ك
نفسه	نفس ه
نفسها	نفس ها
نفسهم	نفس هم
نفسي	نفسي نفسي
نفسيهما	نفسي هما
نفطه	نفط ه
نفطها	نفط ها
نفطهم	نفط هم
نفقاتهم	نفقات هم
نفوذه	نفوذ ه
نفوذها	نفوذ ها
نفوذهم	نفوذ هم
نفوسنا	نفوسنا نفوسنا
نفيه	نفي ه
نقدمها	نقدمها نقدمها
نقلته	نقلت ه
نقلتها	نقلت ها
نقلهم	نقل هم
نقوله	نقول ه
نلمسه	نلمسه نلمسه
نموه	نمو ه
ننصحهم	ننصحهم ننصحهم
نهايته	نهاية ه
نهايتها	نهاية ها
نهبها	نهبها نهبها
نوابه	نواب ه
نواتها	نواة ها
نواجهها	نواجهها نواجهها
نوعه	نوع ه
نوعها	نوع ها
نيته	نية ه
هاتفه	هاتفه هاتفه
هاجمتها	هاجمت ها
هامشه	هامش ه
هبوطه	هبوط ه
هجرته	هجرته هجرته
هدفنا	هدفنا هدفنا
هدفها	هدف ها
هدمها	هدم ها
هدوئها	هدوء ها
هروبه	هروب ه
همومنا	همومنا همومنا
هوياتها	هويات ها
هويتنا	هوية نا
هويته	هوية ه
وآثاره	وآثاره وآثاره وآثاره
وآثارهم	و آثار هم
وآخر	و آخر
وآخراً	و آخرا
وآخرون	و آخرون
وآخرين	و آخرين
وآسيا	و آسيا
وآفاق	وآفاق وآفاق
وآلافاً	و آلافا
وآليات	و آليات
وآلية	و آلية
وآمنة	و آمنة
وأبحاث	و أبحاث
وأبدت	و أبدت
وأبدى	و أبدى
وأبرز	و أبرز
وأبرزت	و أبرزت
وأبلغ	و أبلغ
وأبلغنا	وأبلغنا وأبلغنا
وأبناء	و أبناء
وأبو	وأبو وأبو
وأتبعت	و أتبعت
وأتعاب	و أتعاب
وأثاث	و أثاث
وأثناء	و أثناء
وأجانب	و أجانب
وأجريت	و أجريت
وأجزاء	و أجزاء
وأجمع	و أجمع
وأجمعت	و أجمعت
وأجنبية	و أجنبية
وأجهزة	و أجهزة
وأحاديث	و أحاديث
وأحاط	و أحاط
وأحالتهم	و أحالت هم
وأحجام	و أحجام
وأحد	و أحد
وأحزاب	و أحزاب
وأحزمة	و أحزمة
وأحسن	و أحسن
وأحكمت	و أحكمت
وأحمد	وأحمد وأحمد
وأحيلا	و أحيلا
وأخبر	و أخبر
وأخذ	و أخذ
وأخذت	و أخذت
وأخرى	و أخرى
وأخزيه	وأخزيه وأخزيه وأخزيه
وأخفقت	و أخفقت
وأخيراً	و أخيرا
وأداء	و أداء
وأداة	وأداة وأداة
وأدار	و أدار
وأدب	وأدب وأدب
وأدباء	و أدباء
وأدباً	و أدبا
وأدت	و أدت
وأدرجت	و أدرجت
وأدوات	و أدوات
وأدوار	و أدوار
وأدوية	و أدوية
وأدى	و أدى
وأراد	و أراد
وأرجع	و أرجع
وأرجعت	و أرجعت
وأرجو	وأرجو وأرجو
وأرخص	و أرخص
وأردوه	و أردوا ه
وأرز	و أرز
وأسئلة	و أسئلة
وأساسي	و أساسي
وأسبابها	و أسباب ها
وأسبانيا	و إسبانيا
وأستراليا	و أستراليا
وأستطردت	و استطردت
وأسس	و أسس
وأسعار	و أسعار
وأسفر	و أسفر
وأسفرت	و أسفرت
وأسلاك	و أسلاك
وأسلمت	وأسلمت وأسلمت
وأسمنت	و أسمنت
وأسواق	و أسواق
وأسواقها	و أسواق ها
وأسوان	وأسوان وأسوان
وأشاد	و أشاد
وأشار	و أشار
وأشارت	و أشارت
وأشاروا	و أشاروا
وأشياء	و أشياء
وأصبح	و أصبح
وأصبحت	و أصبحت
وأصحاب	و أصحاب
وأصدقاء	و أصدقاء
وأصر	و أصر
وأصيب	و أصيب
وأضاء	و أضاء
وأضاف	و أضاف
وأضافت	و أضافت
وأضافوا	و أضافوا
وأضعف	و أضعف
وأضفى	و أضفى
وأضيفت	و أضيفت
وأطراف	و أطراف
وأطلعت	و أطلعت
وأطلق	و أطلق
وأطلقوا	و أطلقوا
وأطياف	و أطياف
وأظهرت	و أظهرت
وأعاد	و أعاد
وأعادوا	و أعادوا
وأعتقد	و أعتقد
وأعد	و أعد
وأعرب	و أعرب
وأعربت	و أعربت
وأعضاء	و أعضاء
وأعضائه	و أعضاء ه
وأعطت	و أعطت
وأعطوها	و أعطوا ها
وأعطى	و أعطى
وأعظم	و أعظم
وأعلن	و أعلن
وأعلنت	و أعلنت
وأعلنوا	و أعلنوا
وأعمال	و أعمال
وأعمق	و أعمق
وأغطية	و أغطية
وأغلقت	و أغلقت
وأفاد	و أفاد
وأفادت	و أفادت
وأفريقيا	و أفريقيا
وأفضل	و أفضل
وأفغانستان	و أفغانستان
وأفكاره	و أفكار ه
وأفيد	و أفيد
وأقباط	و أقباط
وأقباطاً	و أقباطا
وأقرته	و أقرت ه
وأقساط	و أقساط
وأقسى	و أقسى
وأقل	و أقل
وأقول	وأقول وأقول
وأكبر	و أكبر
وأكثرها	و أكثر ها
وأكد	و أكد
وأكدت	و أكدت
وأكدوا	و أكدوا
وأكرر	و أكرر
وأكل	و أكل
وألبسة	و ألبسة
وألزمت	و ألزمت
وألفي	و ألفي
وألقت	و ألقت
وألقوا	و ألقوا
وألمانيا	و ألمانيا
وألياف	و ألياف
وأم	و أم
وأمام	و أمام
وأمان	و أمان
وأمر	و أمر
وأمراض	و أمراض
وأمرت	و أمرت
وأمريكا	و أمريكا
وأمل	و أمل
وأميركا	و أميركا
وأميمة	وأميمة وأميمة
وأمين	و أمين
وأن	و أن
وأنا	وأنا وأنا
وأنابيب	و أنابيب
وأنجبت	و أنجبت
وأنشطة	و أنشطة
وأنفقت	و أنفقت
وأنقرة	وأنقرة وأنقرة
وأنقره	وأنقره وأنقره
وأننا	و أن نا
وأنه	و أن ه
وأنها	و أن ها
وأنهم	و أن هم
وأهدافنا	وأهدافنا وأهدافنا وأهدافنا
وأهدافه	و أهداف ه
وأهل	و أهل
وأهلت	و أهلت
وأهم	و أهم
وأهمها	و أهم ها
وأهمية	و أهمية
وأوابك	و أوابك
وأوروبا	و أوروبا
وأوزبكستان	وأوزبكستان وأوزبكستان
وأوصى	و أوصى
وأوضح	و أوضح
وأوضحت	و أوضحت
وأوضحوا	و أوضحوا
وأوضـح	و أوضح
وأوعز	و أوعز
وأوعية	و أوعية
وأوقعت	و أوقعت
وأوقفت	و أوقفت
وأوقفوا	و أوقفوا
وأوكرانيا	وأوكرانيا وأوكرانيا
وأية	و أية
وأيده	و أيد ه
وأيضا	و أيضا
وأيضاً	و أيضا
وأيمن	وأيمن وأيمن
وأين	و أين
وأيّد	و أيد
وأَبْلَغت	وأبلغت وأبلغت
وإبرام	و إبرام
وإبراهيم	وإبراهيم وإبراهيم
وإتاحة	و إتاحة
وإتقان	و إتقان
وإتمام	و إتمام
وإثارة	و إثارة
وإثيوبيا	و أثيوبيا
وإجراء	و إجراء
وإجراءات	و إجراءات
وإجراؤه	و إجراء ه
وإحجام	و إحجام
وإحداث	و إحداث
وإحلال	و إحلال
وإحياء	و إحياء
وإخراجها	و إخراج ها
وإخضاعها	و إخضاع ها
وإخلالهم	و إخلال هم
وإدارة	و إدارة
وإدارته	و إدارة ه
وإذا	و إذا
وإرهابية	و إرهابية
وإزالة	و إزالة
وإسرائيل	و إسرائيل
وإسرائيلية	و إسرائيلية
وإسقاط	و إسقاط
وإسلام	و إسلام
وإسلامياً	و إسلاميا
وإسلامية	و إسلامية
وإسناد	و إسناد
وإشاعة	و إشاعة
وإصابة	و إصابة
وإصدار	و إصدار
وإصرار	و إصرار
وإصلاح	و إصلاح
وإطلاع	و اطلاع
وإعادة	و إعادة
وإعداد	و إعداد
وإعداده	و إعداد ه
وإعطاء	و إعطاء
وإعلانات	و إعلانات
وإعلانه	و إعلان ه
وإعلانها	و إعلان ها
وإغراق	و إغراق
وإقالة	و إقالة
وإقامة	و إقامة
وإلا	و إلا
وإلحاق	و إلحاق
وإلغاء	و إلغاء
وإلى	و إلى
وإمداد	و إمداد
وإمكان	و إمكان
وإمكانات	و إمكانات
وإمكانية	و إمكانية
وإمّا	و إما
وإن	و إن
وإناثاً	و إناثا
وإنتاج	و إنتاج
وإنتاجه	و إنتاج ه
وإنجلترا	و إنجلترا
وإنسانية	و إنسانية
وإنشاء	و إنشاء
وإنعاش	و إنعاش
وإنقاذ	و إنقاذ
وإنما	و إنما
وإنني	وإنني وإنني وإنني
وإنه	و إن ه
وإياد	وإياد وإياد
وإيجاد	و إيجاد
وإيران	و إيران
وإيرانية	و إيرانية
وإيضاح	و إيضاح
وإيطاليا	و إيطاليا
وإيقاظ	و إيقاظ
وائتمان	و ائتمان
وابدى	و أبدى
وابرز	و أبرز
وابرمت	و أبرمت
وابعاد	و إبعاد
وابعدت	و أبعدت
وابقاء	و إبقاء
وابلغ	و أبلغ
وابلغت	و أبلغت
وابلغنا	و أبلغنا
وابنتها	و ابنة ها
وابو	وابو وابو
واتبع	و اتبع
واتجار	و اتجار
واتجاهات	و اتجاهات
واتجاههم	و اتجاه هم
واتجهت	و اتجهت
واتحاد	و اتحاد
واتخاذ	و اتخاذ
واتخذت	و اتخذت
واتخذوا	و اتخذوا
واتساع	و اتساع
واتسمت	و اتسمت
واتضح	و اتضح
واتفاق	و اتفاق
واتفاقات	و اتفاقات
واتفاقاً	و اتفاقا
واتفق	و اتفق
واتفقا	و اتفقا
واتفقت	و اتفقت
واتهامات	و اتهامات
واتهم	و اتهم
واتهمت	و اتهمت
واثبت	و أثبت
واثر	و إثر
واثنان	و اثنان
واثنتان	و اثنتان
واثنين	و اثنين
واجباتنا	واجباتنا واجباتنا
واجبرتها	و أجبرت ها
واجتماعات	و اجتماعات
واجتماعياً	و اجتماعيا
واجتماعية	و اجتماعية
واجتمعت	و اجتمعت
واجتهادات	واجتهادات واجتهادات
واجتياح	و اجتياح
واجراء	و إجراء
واجراءات	واجراءات واجراءات
واجرى	و أجرى
واجهتها	واجهت ها
واجواءهما	و أجواء هما
واحتجاجات	و احتجاجات
واحتجاز	و احتجاز
واحتراق	واحتراق واحتراق
واحترام	و احترام
واحترامهم	واحترامهم واحترامهم واحترامهم
واحترفت	و احترفت
واحتفلت	و احتفلت
واحتكار	و احتكار
واحتلاله	واحتلاله واحتلاله واحتلاله
واحتلالها	و احتلال ها
واحتياطيات	و احتياطيات
واحد	و أحد
واحداهما	واحداهما واحداهما واحداهما
واحرزت	و أحرزت
واحزابا	و أحزابا
واحصاءات	و إحصاءات
واحلال	و إحلال
واحلم	واحلم واحلم
واحمد	واحمد واحمد
واختار	و اختار
واختبارات	و اختبارات
واخترع	و اخترع
واختفت	و اختفت
واختلافات	و اختلافات
واختيار	و اختيار
واخر	و آخر
واخرى	و أخرى
واخلاء	و إخلاء
واخلت	و أخلت
واخيرا	و أخيرا
واخيرة	و أخيرة
واداؤها	و أداء ها
وادارة	و إدارة
وادارته	و إدارة ه
وادارية	و إدارية
وادعاء	و ادعاء
وادلت	و أدلت
وادلى	و أدلى
وادوية	و أدوية
وادى	و أدى
واذا	و إذا
واذربيجان	واذربيجان واذربيجان
واذكر	واذكر واذكر
واذنيها	و أذني ها
واذيال	واذيال واذيال
واربعة	و أربعة
واربعمئة	و أربع مئة
واربعين	و أربعين
واربيل	و أربيل
وارتباك	و ارتباك
وارتفاع	و ارتفاع
وارتفاعه	و ارتفاع ه
وارتفعت	و ارتفعت
وارجع	و أرجع
وارداتنا	وارداتنا وارداتنا
وارداتها	واردات ها
وارسلت	و أرسلت
وارغموا	و أرغموا
وارقام	و أرقام
وارهاب	و إرهاب
واريتريا	و إريتريا
وازالة	وازالة وازالة
وازدادت	و ازدادت
وازمة	و أزمة
واساءة	و إساءة
واسامة	واسامة واسامة
واسبانيا	و إسبانيا
واستأنفوا	و استأنفوا
واستئناف	و استئناف
واستبداله	و استبدال ه
واستثمار	و استثمار
واستثماره	و استثمار ه
واستثمارهم	واستثمارهم واستثمارهم واستثمارهم
واستثماري	و استثماري
واستثمارية	و استثمارية
واستثمرت	و استثمرت
واستجابة	و استجابة
واستجابت	و استجابت
واستجواب	واستجواب واستجواب
واستحدثت	و استحدثت
واستحقاق	واستحقاق واستحقاق
واستخدام	و استخدام
واستخدامات	و استخدامات
واستخداماتها	و استخدامات ها
واستخدامه	و استخدام ه
واستخدامها	واستخدامها واستخدامها واستخدامها
واستخدم	و استخدم
واستدرك	و استدرك
واستدعاءات	و استدعاءات
واستدعوا	و استدعوا
واستدعى	و استدعى
واستراتيجي	و إستراتيجي
واستراتيجية	و إستراتيجية
واستراليا	و أستراليا
واستشاريى	و استشاريي
واستشفاء	و استشفاء
واستصلاح	و استصلاح
واستطلاع	و استطلاع
واستطيع	واستطيع واستطيع
واستعادة	و استعادة
واستعداد	و استعداد
واستعداده	و استعداد ه
واستعرض	و استعرض
واستعمال	و استعمال
واستغرب	و استغرب
واستغربت	و استغربت
واستغرقت	و استغرقت
واستغلال	و استغلال
واستغلالها	و استغلال ها
واستغلت	و استغلت
واستفتاء	و استفتاء
واستقال	و استقال
واستقالة	واستقالة واستقالة
واستقبال	و استقبال
واستقبل	و استقبل
واستقر	و استقر
واستقرارا	و استقرارا
واستقطاب	و استقطاب
واستقلاله	واستقلاله واستقلاله واستقلاله
واستقلاليته	و استقلالية ه
واستكشاف	و استكشاف
واستكمال	و استكمال
واستكملت	و استكملت
واستمرار	و استمرار
واستمرت	و استمرت
واستمعت	و استمعت
واستمعوا	و استمعوا
واستنادا	و استنادا
واستناداً	و استنادا
واستند	و استند
واستندت	و استندت
واستنكارها	واستنكارها واستنكارها واستنكارها
واستنكرت	و استنكرت
واستهدف	و استهدف
واستهلاك	و استهلاك
واستولت	و استولت
واستيراد	و استيراد
واستيراداً	و استيرادا
واسرائيل	و إسرائيل
واسرائيليون	و إسرائيليون
واسرائيليين	و إسرائيليين
واسرهم	واسرهم واسرهم واسرهم
واسفرت	و أسفرت
واسقاط	و إسقاط
واسكان	و إسكان
واسكتلندا	و إسكتلندا
واسلحة	و أسلحة
واسلوبها	واسلوبها واسلوبها واسلوبها
واسوان	واسوان واسوان
واسيا	و آسيا
واشاد	و أشاد
واشار	و أشار
واشارت	و أشارت
واشتبكت	و اشتبكت
واشتبكوا	و اشتبكوا
واشترط	و اشترط
واشترطت	و اشترطت
واشتكت	و اشتكت
واشتكى	و اشتكى
واشراك	و إشراك
واشعاعية	واشعاعية واشعاعية
واشعال	و إشعال
واشــــار	و أشار
واصابة	و إصابة
واصبح	و أصبح
واصبحت	و أصبحت
واصحاب	و أصحاب
واصدرت	و أصدرت
واصرارها	و إصرار ها
واصرت	و أصرت
واصلاح	و إصلاح
واصوله	و أصول ه
واصيب	و أصيب
واضاف	و أضاف
واضافة	و إضافة
واضافت	و أضافت
واضطر	و اضطر
واضطرابات	و اضطرابات
واضعيه	واضعي ه
واضيفت	و أضيفت
واطراف	و أطراف
واطفال	و أطفال
واطفالنا	و أطفال نا
واطلاق	و أطلاق
واطلع	و اطلع
واطلق	و أطلق
واظهرت	و أظهرت
واعادة	و إعادة
واعتبار	و اعتبار
واعتبر	و اعتبر
واعتبرت	و اعتبرت
واعتبرته	و اعتبرت ه
واعتبرتها	و اعتبرت ها
واعتبرها	و اعتبر ها
واعتبروا	و اعتبروا
واعترضت	و اعترضت
واعترف	و اعترف
واعترفت	و اعترفت
واعترفوا	و اعترفوا
واعتزاز	و اعتزاز
واعتقاد	و اعتقاد
واعتقال	و اعتقال
واعتقد	و أعتقد
واعتقل	و اعتقل
واعتماد	و اعتماد
واعتمادها	و اعتماد ها
واعجابه	و إعجاب ه
واعدما	و أعدما
واعرب	و أعرب
واعربت	و أعربت
واعضاء	و أعضاء
واعطاء	و إعطاء
واعطاءها	و إعطاء ها
واعطائها	واعطائها واعطائها واعطائها
واعلانه	و إعلان ه
واعلن	و أعلن
واعلنت	و أعلنت
واعمق	و أعمق
واغتيالات	و اغتيالات
وافاد	و أفاد
وافادت	و أفادت
وافتئاتهم	و افتئات هم
وافتتاح	و افتتاح
وافراحكم	و أفراح كم
وافراد	و أفراد
وافريقيا	و أفريقيا
وافريقية	وافريقية وافريقية
وافكاره	و أفكار ه
وافلاسه	وافلاسه وافلاسه وافلاسه
واقاربهم	و أقارب هم
واقالة	و إقالة
واقامة	و إقامة
واقامت	و أقامت
واقتراح	و اقتراح
واقترح	و اقترح
واقتصادياً	و اقتصاديا
واقتصادية	و اقتصادية
واقتصرت	و اقتصرت
واقتناء	و اقتناء
واقراص	و أقراص
واقرب	و أقرب
واقسام	و أقسام
واقسموا	و أقسموا
واقليمياً	و إقليميا
واكتفت	و اكتفت
واكتفوا	و اكتفوا
واكتفى	و اكتفى
واكتنازه	و اكتناز ه
واكثر	و أكثر
واكد	و أكد
واكدا	و أكدا
واكدت	و أكدت
واكدوا	و أكدوا
والآثار	و الآثار
والآخر	و الآخر
والآسيوية	و الآسيوية
والآشوريين	و الأشوريين
والآلات	و الآلات
والآمال	و الآمال
والأبناء	و الأبناء
والأثاث	و الأثاث
والأجانب	و الأجانب
والأجنبي	و الأجنبي
والأجنبية	و الأجنبية
والأجهزة	و الأجهزة
والأجور	و الأجور
والأحداث	و الأحداث
والأحذية	و الأحذية
والأحزاب	و الأحزاب
والأحلام	و الأحلام
والأحواض	و الأحواض
والأخرى	و الأخرى
والأخشاب	و الأخشاب
والأخطار	والأخطار والأخطار
والأخوة	و الأخوة
والأدب	و الأدب
والأدوات	و الأدوات
والأدوية	و الأدوية
والأراضى	و الأراضي
والأراضي	و الأراضي
والأرامل	و الأرامل
والأربعين	و الأربعين
والأردن	و الأردن
والأرز	و الأرز
والأرصدة	و الأرصدة
والأرواح	والأرواح والأرواح
والأسئلة	و الأسئلة
والأسباب	و الأسباب
والأسرة	و الأسرة
والأسس	و الأسس
والأسعار	و الأسعار
والأسمدة	و الأسمدة
والأسمنت	و الأسمنت
والأسواق	و الأسواق
والأشغال	و الأشغال
والأشقاء	و الأشقاء
والأصدقاء	و الأصدقاء
والأطباء	و الأطباء
والأطراف	و الأطراف
والأعراض	و الأعراض
والأعراف	و الأعراف
والأعشاب	و الأعشاب
والأفراد	و الأفراد
والأفريقية	و الأفريقية
والأقارب	و الأقارب
والأقباط	و الأقباط
والأقسام	و الأقسام
والأقل	و الأقل
والألبان	و الألبان
والألماس	و الألماس
والألياف	و الألياف
والأمان	و الأمان
والأمة	و الأمة
والأمر	و الأمر
والأمريكي	و الأمريكي
والأمريكية	و الأمريكية
والأمريكيين	و الأمريكيين
والأمم	و الأمم
والأمن	و الأمن
والأمومة	و الأمومة
والأميركية	و الأميركية
والأناقة	والأناقة والأناقة
والأنثى	والأنثى والأنثى
والأنسجة	و الأنسجة
والأنواع	و الأنواع
والأهداف	و الأهداف
والأهلي	و الأهلي
والأهم	و الأهم
والأوروبي	و الأوروبي
والأوروبية	و الأوروبية
والأوضاع	و الأوضاع
والإبداع	و الإبداع
والإبداعية	و الإبداعية
والإجراءات	و الإجراءات
والإحسان	و الإحسان
والإحصاء	و الإحصاء
والإدارية	و الإدارية
والإرشاد	و الإرشاد
والإرهاب	و الإرهاب
والإسترليني	و الإسترليني
والإسرائيلي	و الإسرائيلي
والإسرائيليين	و الإسرائيليين
والإسراع	و الإسراع
والإسكان	و الإسكان
والإسلامي	و الإسلامي
والإسلامية	و الإسلامية
والإشراف	و الإشراف
والإصرار	و الإصرار
والإصلاح	و الإصلاح
والإصلاحات	و الإصلاحات
والإطارات	و الإطارات
والإعداد	و الإعداد
والإعزاز	و الإعزاز
والإعمار	والإعمار والإعمار
والإغراق	و الإغراق
والإقبال	و الإقبال
والإقراض	و الإقراض
والإقليمية	و الإقليمية
والإمارات	و الإمارات
والإمعان	و الإمعان
والإنارة	و الإنارة
والإنتاج	و الإنتاج
والإنترنت	و الإنترنت
والإنجاز	و الإنجاز
والإنسانية	و الإنسانية
والإنشاءات	و الإنشاءات
والإيراني	و الإيراني
والا	و إلا
والابتدائية	و الابتدائية
والابحاث	و الأبحاث
والابداع	و الإبداع
والابقاء	و الإبقاء
والابواب	والابواب والابواب
والاتجار	و الاتجار
والاتجاه	و الاتجاه
والاتجاهات	و الاتجاهات
والاتحاد	و الاتحاد
والاتصالات	و الاتصالات
والاتفاق	و الاتفاق
والاتفاقات	و الاتفاقات
والاتفاقيات	و الاتفاقيات
والاتهامات	و الاتهامات
والاثنين	و الاثنين
والاجتماع	و الاجتماع
والاجتماعي	و الاجتماعي
والاجتماعية	و الاجتماعية
والاجتهاد	و الاجتهاد
والاجراءات	و الإجراءات
والاجنبية	و الأجنبية
والاجهزة	و الأجهزة
والاحباط	والاحباط والاحباط
والاحترافية	والاحترافية والاحترافية
والاحتلال	و الاحتلال
والاحتياطات	و الاحتياطات
والاحزاب	و الأحزاب
والاحفاد	والاحفاد والاحفاد
والاحوال	و الأحوال
والاحياء	و الأحياء
والاختلاف	والاختلاف والاختلاف
والاخيرة	والاخيرة والاخيرة
والاداب	و الآداب
والادارات	و الإدارات
والادارة	و الإدارة
والادارى	و الإداري
والاداري	والاداري والاداري
والادارية	و الإدارية
والادب	والادب والادب
والادق	والادق والادق
والادوية	و الأدوية
والاديان	و الأديان
والاذاعات	و الإذاعات
والاذاعة	و الإذاعة
والاذون	والاذون والاذون
والارادة	والارادة والارادة
والاراضى	والاراضى والاراضى
والارتباك	و الارتباك
والارتقاء	و الارتقاء
والارجنتيني	و الأرجنتيني
والاردن	و الأردن
والارض	و الأرض
والارقام	و الأرقام
والارهاب	و الإرهاب
والازدهار	و الازدهار
والاسباني	و الإسباني
والاسبانية	و الإسبانية
والاستئثار	و الاستئثار
والاستئناف	و الاستئناف
والاستثمار	و الاستثمار
والاستثمارات	و الاستثمارات
والاستثماري	و الاستثماري
والاستثمارية	و الاستثمارية
والاستجابة	و الاستجابة
والاستحواذ	والاستحواذ والاستحواذ
والاستخباريين	و الاستخباريين
والاستراتيجيات	و الإستراتيجيات
والاستراتيجية	و الإستراتيجية
والاسترالي	و الأسترالي
والاستشارات	و الاستشارات
والاستشارة	و الاستشارة
والاستشهاد	و الاستشهاد
والاستعداد	و الاستعداد
والاستعمار	و الاستعمار
والاستغلال	و الاستغلال
والاستفادة	و الاستفادة
والاستفزاز	و الاستفزاز
والاستقالة	والاستقالة والاستقالة
والاستقبال	و الاستقبال
والاستقرار	و الاستقرار
والاستقلالية	والاستقلالية والاستقلالية
والاستكشاف	و الاستكشاف
والاستماع	و الاستماع
والاستمرار	و الاستمرار
والاستنكار	و الاستنكار
والاستهلاك	و الاستهلاك
والاستيراد	و الاستيراد
والاسرائيلى	و الإسرائيلي
والاسرائيلي	و الإسرائيلي
والاسرائيلية	و الإسرائيلية
والاسرائيليون	و الإسرائيليون
والاسرائيليين	و الإسرائيليين
والاسكندرية	و الإسكندرية
والاسلامي	والاسلامي والاسلامي
والاسلامية	والاسلامية والاسلامية
والاسماعيلي	والاسماعيلي والاسماعيلي
والاشاعات	والاشاعات والاشاعات
والاطاحة	و الإطاحة
والاطفائيين	و الإطفائيين
والاطفال	والاطفال والاطفال
والاطلاع	و الاطلاع
والاعتدال	و الاعتدال
والاعتراض	و الاعتراض
والاعتراف	و الاعتراف
والاعتماد	و الاعتماد
والاعدام	والاعدام والاعدام
والاعراف	و الأعراف
والاعراق	و الأعراق
والاعشاب	و الأعشاب
والاعلام	و الإعلام
والاعلامية	و الإعلامية
والاعلان	والاعلان والاعلان
والاعمار	و الإعمار
والاغتصاب	و الاغتصاب
والاغتيالات	و الاغتيالات
والاغراءات	و الإغراءات
والاف	و آلاف
والافات	والافات والافات
والافاضة	والافاضة والافاضة
والافعال	و الأفعال
والافواه	والافواه والافواه
والاقالات	والاقالات والاقالات
والاقبال	و الإقبال
والاقتراح	و الاقتراح
والاقتراض	و الاقتراض
والاقتصاد	و الاقتصاد
والاقتصادى	و الاقتصادي
والاقتصادي	و الاقتصادي
والاقتصادية	و الاقتصادية
والاقرار	و الإقرار
والاقراض	و الإقراض
والاقلية	والاقلية والاقلية
والاقليمي	والاقليمي والاقليمي
والاكراد	والاكراد والاكراد
والاكوادور	والاكوادور والاكوادور
والالتزام	و الالتزام
والالعاب	و الألعاب
والالغاء	والالغاء والالغاء
والالكترونية	و الإلكترونية
والامارات	و الإمارات
والاماراتي	و الإماراتي
والاماكن	و الأماكن
والامام	و الإمام
والامريكية	و الأمريكية
والامكانات	والامكانات والامكانات
والامم	و الأمم
والامن	و الأمن
والامنية	و الأمنية
والامير	و الأمير
والاميركي	و الأميركي
والاميركية	و الأميركية
والامين	والامين والامين
والانتاج	و الإنتاج
والانتاجية	والانتاجية والانتاجية
والانتخابات	و الانتخابات
والانترنت	و الإنترنت
والانتماء	و الانتماء
والانجاز	و الإنجاز
والانجازات	و الإنجازات
والانحدار	و الانحدار
والانحلال	و الانحلال
والانحياز	والانحياز والانحياز
والاندونيسي	و الإندونيسي
والانسان	و الإنسان
والانسانية	والانسانية والانسانية
والانشطة	و الأنشطة
والانضمام	والانضمام والانضمام
والانفتاح	و الانفتاح
والانقضاض	و الانقضاض
والانقطاع	و الانقطاع
والاهتمام	و الاهتمام
والاهلي	والاهلي والاهلي
والاوتوستراد	والاوتوستراد والاوتوستراد
والاوربيون	و الأوربيون
والاوروبيين	و الأوروبيين
والايراني	و الإيراني
والايطالي	و الإيطالي
والايطالية	و الإيطالية
والايقونات	والايقونات والايقونات
والباقي	والباقي والباقي
والباكستاني	و الباكستاني
والبالغ	و البالغ
والبالغة	و البالغة
والبانيا	و ألبانيا
والبترول	و البترول
والبحارة	و البحارة
والبحث	و البحث
والبحثية	و البحثية
والبحر	و البحر
والبحري	و البحري
والبحرية	و البحرية
والبحرين	و البحرين
والبحوث	والبحوث والبحوث
والبحيرات	و البحيرات
والبدء	و البدء
والبدري	والبدري والبدري
والبذور	و البذور
والبر	و البر
والبرازيلي	و البرازيلي
والبرامج	و البرامج
والبراميل	و البراميل
والبراهمة	والبراهمة والبراهمة
والبرتغال	و البرتغال
والبرتقال	و البرتقال
والبرزاني	والبرزاني والبرزاني
والبركة	و البركة
والبرلمان	و البرلمان
والبرنامج	و البرنامج
والبروفسور	والبروفسور والبروفسور
والبري	و البري
والبريد	و البريد
والبريطانى	و البريطاني
والبريطانية	و البريطانية
والبريطانيين	و البريطانيين
والبستانية	و البستانية
والبشري	و البشري
والبصرية	و البصرية
والبصل	و البصل
والبطاريات	و البطاريات
والبطاطس	و البطاطس
والبطاطين	والبطاطين والبطاطين
والبطاقات	و البطاقات
والبعد	و البعد
والبعض	والبعض والبعض
والبقية	و البقية
والبلاد	والبلاد والبلاد
والبلجيكي	و البلجيكي
والبلجيكية	و البلجيكية
والبلد	و البلد
والبن	و البن
والبناء	و البناء
والبنات	و البنات
والبنتاغون	و البنتاغون
والبنزين	و البنزين
والبنك	و البنك
والبنوك	و البنوك
والبنية	و البنية
والبورصة	و البورصة
والبوسنة	و البوسنة
والبيئى	و البيئي
والبيئية	و البيئية
والبيان	والبيان والبيان
والبيض	و البيض
والبيولوجية	والبيولوجية والبيولوجية
والتآزر	و التآزر
والتآمر	والتآمر والتآمر
والتأثير	و التأثير
والتأثيرات	والتأثيرات والتأثيرات
والتأجير	و التأجير
والتأكد	و التأكد
والتأمين	و التأمين
والتأمينات	و التأمينات
والتأويل	و التأويل
والتابعة	و التابعة
والتجار	و التجار
والتجارة	و التجارة
والتجاري	و التجاري
والتجارية	و التجارية
والتجديد	و التجديد
والتجرؤ	و التجرؤ
والتجرد	و التجرد
والتجزئة	و التجزئة
والتجسيد	و التجسيد
والتجمع	و التجمع
والتجمعات	والتجمعات والتجمعات
والتجهيز	و التجهيز
والتجوال	و التجوال
والتجول	و التجول
والتحايل	والتحايل والتحايل
والتحذير	و التحذير
والتحرك	و التحرك
والتحركات	و التحركات
والتحرير	و التحرير
والتحريض	و التحريض
والتحصيل	و التحصيل
والتحضير	و التحضير
والتحفظ	و التحفظ
والتحليل	و التحليل
والتخاطب	و التخاطب
والتخبط	و التخبط
والتخطيط	و التخطيط
والتخفيضات	و التخفيضات
والتخلص	و التخلص
والتدخل	و التدخل
والتدريب	و التدريب
والتدريس	و التدريس
والتدمير	والتدمير والتدمير
والتراث	و التراث
والتراجع	و التراجع
والتراخيص	و التراخيص
والتربح	والتربح والتربح
والتربص	و التربص
والتربية	و التربية
والترتيب	و الترتيب
والترفيهية	و الترفيهية
والترقب	و الترقب
والتركي	و التركي
والترويج	و الترويج
والتزامات	و التزامات
والتزاماته	و التزامات ه
والتزاماً	و التزاما
والتزامه	والتزامه والتزامه والتزامه
والتزامها	والتزامها والتزامها والتزامها
والتزامهم	و التزام هم
والتزويد	و التزويد
والتسعين	و التسعين
والتسلل	والتسلل والتسلل
والتسليح	و التسليح
والتسهيلات	و التسهيلات
والتسوق	و التسوق
والتسوية	و التسوية
والتسويق	و التسويق
والتشاور	و التشاور
والتشديد	و التشديد
والتشرذم	و التشرذم
والتشريعية	و التشريعية
والتشيكي	و التشيكي
والتشيلي	و التشيلي
والتشييد	و التشييد
والتصادم	والتصادم والتصادم
والتصدير	و التصدير
والتصرف	والتصرف والتصرف
والتصعيد	و التصعيد
والتصميم	و التصميم
والتصويت	و التصويت
والتضامن	و التضامن
والتضحية	و التضحية
والتضخم	و التضخم
والتطبيع	و التطبيع
والتطرف	و التطرف
والتطهير	والتطهير والتطهير
والتطور	و التطور
والتطورات	و التطورات
والتطوير	و التطوير
والتظاهرات	و التظاهرات
والتعاطي	والتعاطي والتعاطي
والتعالي	و التعالي
والتعامل	و التعامل
والتعاون	و التعاون
والتعبئة	و التعبئة
والتعبير	و التعبير
والتعديلات	و التعديلات
والتعدين	و التعدين
والتعدينية	و التعدينية
والتعذيب	و التعذيب
والتعري	والتعري والتعري
والتعقيدات	و التعقيدات
والتعليم	و التعليم
والتعليمية	و التعليمية
والتعمير	و التعمير
والتعود	و التعود
والتغلب	و التغلب
والتغليف	و التغليف
والتغيير	و التغيير
والتفانى	والتفانى والتفانى
والتفاوض	و التفاوض
والتفتيش	و التفتيش
والتفجيرات	و التفجيرات
والتفريغ	و التفريغ
والتفريق	و التفريق
والتقارير	و التقارير
والتقاليد	و التقاليد
والتقدم	والتقدم والتقدم
والتقدير	والتقدير والتقدير
والتقليل	و التقليل
والتقنيات	و التقنيات
والتقنية	و التقنية
والتقوى	والتقوى والتقوى
والتقى	و التقى
والتكافل	والتكافل والتكافل
والتكامل	و التكامل
والتكفير	والتكفير والتكفير
والتكليفات	و التكليفات
والتكنولوجي	و التكنولوجي
والتكنولوجيا	و التكنولوجيا
والتلفزيون	و التلفزيون
والتلفزيونية	و التلفزيونية
والتلوث	و التلوث
والتليفزيون	والتليفزيون والتليفزيون
والتليفونات	والتليفونات والتليفونات
والتمارين	و التمارين
والتمحيص	والتمحيص والتمحيص
والتمني	و التمني
والتمييز	و التمييز
والتنازل	و التنازل
والتنسيق	و التنسيق
والتنظيمات	و التنظيمات
والتنقيب	و التنقيب
والتنموية	و التنموية
والتنمية	و التنمية
والتهجمات	والتهجمات والتهجمات
والتهجير	والتهجير والتهجير
والتهديدات	والتهديدات والتهديدات
والتهم	والتهم والتهم
والتهميش	والتهميش والتهميش
والتهيئة	و التهيئة
والتوجيه	و التوجيه
والتوريد	و التوريد
والتوزيع	و التوزيع
والتوسع	و التوسع
والتوصل	و التوصل
والتوصيات	و التوصيات
والتوقف	و التوقف
والتونسي	و التونسي
والتونسيات	و التونسيات
والتى	و التي
والتي	و التي
والتيارات	و التيارات
والثابت	و الثابت
والثالث	و الثالث
والثالثة	و الثالثة
والثامن	و الثامن
والثاني	و الثاني
والثانية	و الثانية
والثروة	و الثروة
والثقافات	و الثقافات
والثقافة	و الثقافة
والثقافي	والثقافي والثقافي
والثقافية	و الثقافية
والثقة	و الثقة
والثلاثين	و الثلاثين
والثلاجات	و الثلاجات
والثورة	و الثورة
والثوم	و الثوم
والجامعات	و الجامعات
والجامعة	و الجامعة
والجانب	و الجانب
والجبس	و الجبس
والجبهة	والجبهة والجبهة
والجدية	و الجدية
والجديد	والجديد والجديد
والجديدة	و الجديدة
والجدير	و الجدير
والجرارات	و الجرارات
والجرانيت	و الجرانيت
والجرثومية	والجرثومية والجرثومية
والجرحى	و الجرحى
والجري	والجري والجري
والجزائر	و الجزائر
والجغرافياً	والجغرافيا والجغرافيا
والجلد	و الجلد
والجلدية	و الجلدية
والجمارك	و الجمارك
والجماعات	و الجماعات
والجمال	والجمال والجمال
والجماهيري	و الجماهيري
والجمبرى	والجمبرى والجمبرى
والجمركية	و الجمركية
والجمع	و الجمع
والجمعة	والجمعة والجمعة
والجمعية	و الجمعية
والجمهورية	والجمهورية والجمهورية
والجميل	و الجميل
والجنوب	و الجنوب
والجنيه	و الجنيه
والجهاد	و الجهاد
والجهود	و الجهود
والجوار	و الجوار
والجوي	و الجوي
والجيزة	و الجيزة
والجيش	و الجيش
والجيولوجية	و الجيولوجية
والحاجة	و الحاجة
والحاصلات	والحاصلات والحاصلات
والحافلات	و الحافلات
والحال	و الحال
والحبوب	و الحبوب
والحج	و الحج
والحجارة	و الحجارة
والحجر	و الحجر
والحد	و الحد
والحدود	و الحدود
والحديث	و الحديث
والحديد	و الحديد
والحرارة	و الحرارة
والحراسة	و الحراسة
والحرب	و الحرب
والحرة	و الحرة
والحرص	و الحرص
والحرف	والحرف والحرف
والحركة	و الحركة
والحروب	و الحروب
والحريات	و الحريات
والحرية	و الحرية
والحزب	و الحزب
والحزبية	و الحزبية
والحسين	و الحسين
والحصاد	و الحصاد
والحصول	و الحصول
والحض	و الحض
والحضارية	و الحضارية
والحضور	والحضور والحضور
والحظر	و الحظر
والحفاظ	و الحفاظ
والحقوق	و الحقوق
والحكمة	و الحكمة
والحكومات	و الحكومات
والحكومة	و الحكومة
والحكومية	و الحكومية
والحل	و الحل
والحلوى	و الحلوى
والحمائم	و الحمائم
والحماية	و الحماية
والحمد	و الحمد
والحوار	و الحوار
والحوارات	و الحوارات
والحوافز	و الحوافز
والحياء	و الحياء
والحيطة	و الحيطة
والحيوانات	و الحيوانات
والخارج	و الخارج
والخارجي	و الخارجي
والخارجية	و الخارجية
والخاص	و الخاص
والخاصة	و الخاصة
والخبراء	و الخبراء
والخبرات	و الخبرات
والخبرة	و الخبرة
والخدمات	و الخدمات
والخدمية	و الخدمية
والخراطيم	و الخراطيم
والخروج	و الخروج
والخصم	و الخصم
والخضر	و الخضر
والخضروات	والخضروات والخضروات
والخط	و الخط
والخطط	و الخطط
والخطف	و الخطف
والخطوات	و الخطوات
والخطوط	و الخطوط
والخطى	والخطى والخطى
والخطيرة	و الخطيرة
والخلاص	والخلاص والخلاص
والخلاف	و الخلاف
والخلفية	و الخلفية
والخليج	و الخليج
والخليجية	والخليجية والخليجية
والخمسين	و الخمسين
والخمسينات	والخمسينات والخمسينات
والخميس	و الخميس
والخيار	و الخيار
والخيانة	والخيانة والخيانة
والخير	و الخير
والخيوط	و الخيوط
والدائم	و الدائم
والداخلية	و الداخلية
والداني	و الداني
والدته	والدة ه
والدتها	والدة ها
والدخول	و الدخول
والدروس	و الدروس
والدستور	و الدستور
والدستوري	و الدستوري
والدعارة	و الدعارة
والدعم	و الدعم
والدعوة	و الدعوة
والدفاع	و الدفاع
والدفاعية	والدفاعية والدفاعية
والدكتور	و الدكتور
والدليل	و الدليل
والدنمارك	و الدنمارك
والده	والد ه
والدها	والد ها
والدهانات	و الدهانات
والدواء	و الدواء
والدوائر	و الدوائر
والدوائية	و الدوائية
والدوران	و الدوران
والدول	و الدول
والدولي	و الدولي
والدولية	و الدولية
والديار	و الديار
والديمقراطية	و الديمقراطية
والديموجرافيا	والديموجرافيا والديموجرافيا
والديموقراطي	و الديموقراطي
والديموقراطية	و الديموقراطية
والدين	و الدين
والدينية	و الدينية
والديوانية	و الديوانية
والذخائر	و الذخائر
والذخيرة	و الذخيرة
والذرة	و الذرة
والذهب	و الذهب
والذى	و الذي
والذي	و الذي
والذين	و الذين
والرأسمال	و الرأسمال
والرئيس	و الرئيس
والرافضة	و الرافضة
والرافضون	و الرافضون
والراوى	والراوى والراوى
والرجال	و الرجال
والرجم	و الرجم
والرحلات	والرحلات والرحلات
والرحلة	و الرحلة
والرحمة	و الرحمة
والرخاء	والرخاء والرخاء
والرخام	و الرخام
والرد	و الرد
والرسائل	و الرسائل
والرسميين	و الرسميين
والرسوم	و الرسوم
والرشاشات	و الرشاشات
والرشوة	و الرشوة
والرعاية	و الرعاية
والرغبة	و الرغبة
والرفاهية	والرفاهية والرفاهية
والرقابة	و الرقابة
والرقص	و الرقص
والرقيق	و الرقيق
والرهان	والرهان والرهان
والرهينة	و الرهينة
والروح	والروح والروح
والروسية	و الروسية
والرومانسية	و الرومانسية
والرومانية	و الرومانية
والري	و الري
والرياء	و الرياء
والرياضة	و الرياضة
والرياضية	و الرياضية
والريال	و الريال
والريان	والريان والريان
والريحاني	والريحاني والريحاني
والزبادي	و الزبادي
والزجاج	و الزجاج
والزراعة	و الزراعة
والزراعية	و الزراعية
والزعيم	و الزعيم
والزملاء	والزملاء والزملاء
والزنا	والزنا والزنا
والزوايا	و الزوايا
والزيارة	و الزيارة
والزيوت	و الزيوت
والسؤال	و السؤال
والسابع	والسابع والسابع
والسادات	و السادات
والسادس	و السادس
والساعة	و الساعة
والساعي	و الساعي
والساعية	و الساعية
والسبب	و السبب
والسبت	و السبت
والستين	و الستين
والسجائر	و السجائر
والسجاد	و السجاد
والسجون	و السجون
والسرقة	و السرقة
والسريع	و السريع
والسريعة	و السريعة
والسعادة	و السعادة
والسعر	و السعر
والسعودي	و السعودي
والسعودية	و السعودية
والسعوديين	و السعوديين
والسعي	و السعي
والسفارة	و السفارة
والسفير	و السفير
والسفيرة	و السفيرة
والسكان	و السكان
والسكر	و السكر
والسكرتير	والسكرتير والسكرتير
والسل	و السل
والسلاح	و السلاح
والسلام	و السلام
والسلامة	و السلامة
والسلطات	و السلطات
والسلطة	و السلطة
والسلع	و السلع
والسلوفاكي	و السلوفاكي
والسلوفاكية	و السلوفاكية
والسماح	و السماح
والسنة	و السنة
والسندات	و السندات
والسنغافورية	و السنغافورية
والسهر	والسهر والسهر
والسهم	و السهم
والسودان	و السودان
والسوداني	و السوداني
والسودانيين	و السودانيين
والسوريات	و السوريات
والسورية	و السورية
والسوق	و السوق
والسوقية	و السوقية
والسويد	و السويد
والسويدي	و السويدي
والسويسرية	و السويسرية
والسياحة	و السياحة
والسياحي	و السياحي
والسيارات	و السيارات
والسيارة	و السيارة
والسياسات	و السياسات
والسياسة	و السياسة
والسياسى	و السياسي
والسياسي	و السياسي
والسياسية	و السياسية
والسياسيين	و السياسيين
والسيدات	و السيدات
والسيراميك	والسيراميك والسيراميك
والسيطرة	و السيطرة
والسينما	و السينما
والسيور	و السيور
والشؤون	و الشؤون
والشابات	والشابات والشابات
والشامل	و الشامل
والشباب	و الشباب
والشبابى	و الشبابي
والشبابية	و الشبابية
والشبابيك	والشبابيك والشبابيك
والشبكة	و الشبكة
والشتات	و الشتات
والشجاعة	و الشجاعة
والشجب	و الشجب
والشحات	و الشحات
والشحن	و الشحن
والشخصيات	و الشخصيات
والشراء	و الشراء
والشراكة	و الشراكة
والشرايين	و الشرايين
والشرطة	و الشرطة
والشرف	و الشرف
والشرق	و الشرق
والشرقية	و الشرقية
والشركات	و الشركات
والشريعة	والشريعة والشريعة
والشعب	و الشعب
والشعبي	و الشعبي
والشعبية	و الشعبية
والشعراء	و الشعراء
والشعوب	و الشعوب
والشعور	والشعور والشعور
والشقي	والشقي والشقي
والشكاوى	و الشكاوى
والشمال	والشمال والشمال
والشمس	و الشمس
والشمندورات	و الشمندورات
والشهرة	و الشهرة
والشورى	والشورى والشورى
والشيء	و الشيء
والشيوخ	و الشيوخ
والصابون	والصابون والصابون
والصادر	و الصادر
والصادرات	و الصادرات
والصباغة	و الصباغة
والصبر	و الصبر
والصحافة	و الصحافة
والصحافيين	و الصحافيين
والصحة	و الصحة
والصحى	و الصحي
والصحية	و الصحية
والصدر	و الصدر
والصديقة	و الصديقة
والصرف	و الصرف
والصعوبات	و الصعوبات
والصعود	و الصعود
والصغار	و الصغار
والصغيرة	و الصغيرة
والصفح	و الصفح
والصقري	والصقري والصقري
والصلاة	و الصلاة
والصلب	و الصلب
والصليب	و الصليب
والصناديق	و الصناديق
والصناعات	و الصناعات
والصناعة	و الصناعة
والصناعي	و الصناعي
والصناعية	و الصناعية
والصهيونية	و الصهيونية
والصورة	و الصورة
والصومال	و الصومال
والصيادلة	والصيادلة والصيادلة
والصيانة	و الصيانة
والصيد	و الصيد
والصيغ	والصيغ والصيغ
والصين	و الصين
والصينية	و الصينية
والضابط	و الضابط
والضرائب	و الضرائب
والضروريات	والضروريات والضروريات
والضغوط	و الضغوط
والضوء	و الضوء
والضوابط	و الضوابط
والطائرات	و الطائرات
والطائرة	و الطائرة
والطاقة	و الطاقة
والطبابة	والطبابة والطبابة
والطباعة	و الطباعة
والطبية	و الطبية
والطبيين	و الطبيين
والطرق	و الطرق
والطرقات	و الطرقات
والطرود	و الطرود
والطريقة	و الطريقة
والطعمية	و الطعمية
والطفلة	و الطفلة
والطلاب	و الطلاب
والطلب	و الطلب
والطلبة	و الطلبة
والطلبيات	و الطلبيات
والطوارئ	و الطوارئ
والطويل	و الطويل
والطويلة	و الطويلة
والطيران	و الطيران
والظهور	و الظهور
والعائلة	والعائلة والعائلة
والعاشر	و العاشر
والعافية	و العافية
والعالم	و العالم
والعالمي	و العالمي
والعالمية	و العالمية
والعام	و العام
والعاملين	و العاملين
والعبور	والعبور والعبور
والعتيبي	والعتيبي والعتيبي
والعثماني	و العثماني
والعدالة	و العدالة
والعدس	و العدس
والعدل	و العدل
والعدوان	و العدوان
والعراق	و العراق
والعراقي	و العراقي
والعراقيات	و العراقيات
والعراقية	و العراقية
والعرب	و العرب
والعربي	و العربي
والعربية	و العربية
والعرفي	و العرفي
والعرقية	و العرقية
والعروبة	و العروبة
والعزائم	و العزائم
والعسكري	و العسكري
والعسكرية	و العسكرية
والعسكريين	و العسكريين
والعسل	و العسل
والعشائر	و العشائر
والعشرين	و العشرين
والعصر	والعصر والعصر
والعصيبة	و العصيبة
والعقارات	و العقارات
والعقل	و العقل
والعقول	و العقول
والعكس	و العكس
والعلاج	و العلاج
والعلاجي	و العلاجي
والعلاقات	و العلاقات
والعلاقة	و العلاقة
والعلامات	و العلامات
والعلماء	و العلماء
والعلمى	و العلمي
والعلوم	و العلوم
والعمالة	و العمالة
والعمرة	و العمرة
والعمق	و العمق
والعمل	و العمل
والعملات	و العملات
والعملة	و العملة
والعمليات	و العمليات
والعميد	و العميد
والعنصرية	و العنصرية
والعنف	و العنف
والعودة	و العودة
والعيادات	و العيادات
والعيش	والعيش والعيش
والغاء	و إلغاء
والغائها	والغائها والغائها والغائها
والغاز	و الغاز
والغذائية	و الغذائية
والغرف	و الغرف
والغرفة	و الغرفة
والغريب	و الغريب
والغزل	و الغزل
والغزو	والغزو والغزو
والغزول	و الغزول
والغسالات	و الغسالات
والغطس	و الغطس
والغـــربية	و الغربية
والغفران	و الغفران
والـــ	و ال
والف	و ألف
والفاحشة	و الفاحشة
والفاقد	و الفاقد
والفاكهة	و الفاكهة
والفتاة	و الفتاة
والفجور	و الفجور
والفراء	و الفراء
والفرامل	و الفرامل
والفرضيات	و الفرضيات
والفرنسي	و الفرنسي
والفرنسية	و الفرنسية
والفرنسيين	و الفرنسيين
والفساد	و الفساد
والفسق	و الفسق
والفشل	و الفشل
والفصائل	و الفصائل
والفضة	والفضة والفضة
والفضيلة	و الفضيلة
والفقراء	و الفقراء
والفكر	والفكر والفكر
والفكرة	و الفكرة
والفكرية	و الفكرية
والفلسطينى	و الفلسطيني
والفلسطيني	و الفلسطيني
والفلسطينية	و الفلسطينية
والفلسطينيون	و الفلسطينيون
والفلسطينيين	و الفلسطينيين
والفلسفة	و الفلسفة
والفليبين	والفليبين والفليبين
والفنانات	و الفنانات
والفنانين	و الفنانين
والفنون	و الفنون
والفني	و الفني
والفنية	و الفنية
والفهم	و الفهم
والفواكه	و الفواكه
والفول	و الفول
والفيلسوف	و الفيلسوف
والفيليبينيين	و الفيليبينيين
والقائد	والقائد والقائد
والقائمين	و القائمين
والقادرة	و القادرة
والقادمين	و القادمين
والقارات	و القارات
والقاضي	والقاضي والقاضي
والقانون	و القانون
والقاهرة	و القاهرة
والقبطي	و القبطي
والقبطية	و القبطية
والقبيلة	والقبيلة والقبيلة
والقت	و ألقت
والقدمين	و القدمين
والقديمة	و القديمة
والقرار	و القرار
والقرارات	و القرارات
والقرغيزستانية	و القرغيزستانية
والقروض	و القروض
والقسم	و القسم
والقضاء	و القضاء
والقضائية	و القضائية
والقضايا	و القضايا
والقضية	و القضية
والقطاع	و القطاع
والقطري	و القطري
والقطع	و القطع
والقطن	و القطن
والقفل	والقفل والقفل
والقلب	و القلب
والقليوبية	و القليوبية
والقمح	و القمح
والقمر	و القمر
والقنبلتان	و القنبلتان
والقنص	والقنص والقنص
والقوات	و القوات
والقواعد	و القواعد
والقوانين	و القوانين
والقوة	و القوة
والقومية	و القومية
والقوى	و القوى
والقى	و ألقى
والقيادة	والقيادة والقيادة
والقيام	و القيام
والقيم	و القيم
والكابلات	والكابلات والكابلات
والكاتب	و الكاتب
والكاريبي	والكاريبي والكاريبي
والكافيين	و الكافيين
والكبار	و الكبار
والكبت	و الكبت
والكبسولة	و الكبسولة
والكتاتيب	و الكتاتيب
والكتان	و الكتان
والكحول	و الكحول
والكرامة	والكرامة والكرامة
والكربون	والكربون والكربون
والكرديات	و الكرديات
والكرواتي	و الكرواتي
والكساد	و الكساد
والكلدانيين	والكلدانيين والكلدانيين
والكليات	و الكليات
والكمال	و الكمال
والكندية	و الكندية
والكهرباء	و الكهرباء
والكوري	و الكوري
والكوكايين	والكوكايين والكوكايين
والكوميسا	والكوميسا والكوميسا
والكويت	و الكويت
والكويتي	و الكويتي
والكيان	و الكيان
والكيماوية	و الكيماوية
واللاجئين	و اللاجئين
واللاعب	و اللاعب
واللافت	و اللافت
واللانظام	واللانظام واللانظام
واللبنانى	و اللبناني
واللبناني	و اللبناني
واللتان	و اللتان
واللجان	و اللجان
واللجنة	و اللجنة
واللحوم	و اللحوم
واللذان	و اللذان
واللعبة	و اللعبة
واللقاءات	و اللقاءات
واللقاح	و اللقاح
والله	و اللٰه
واللهجات	و اللهجات
واللوازم	و اللوازم
والليبرالي	و الليبرالي
والمأكولات	و المأكولات
والمؤازرة	والمؤازرة والمؤازرة
والمؤتمر	و المؤتمر
والمؤثرات	و المؤثرات
والمؤسسات	و المؤسسات
والمؤسسة	و المؤسسة
والمؤشرات	و المؤشرات
والمؤهلة	و المؤهلة
والمؤيدة	و المؤيدة
والماء	و الماء
والمادية	و المادية
والماركات	و الماركات
والماضية	و الماضية
والمالية	و المالية
والماليزي	و الماليزي
والمانيا	و ألمانيا
والمانيان	و ألمانيان
والمبادرة	و المبادرة
والمبردات	و المبردات
والمبيعات	و المبيعات
والمتابعة	و المتابعة
والمتانة	والمتانة والمتانة
والمتباينة	و المتباينة
والمتجددة	و المتجددة
والمتحدة	و المتحدة
والمتخصصة	و المتخصصة
والمتخصصون	و المتخصصون
والمتخصصين	و المتخصصين
والمتطور	و المتطور
والمتعاون	والمتعاون والمتعاون
والمتعثرين	و المتعثرين
والمتعلق	و المتعلق
والمتعلقة	و المتعلقة
والمتفجرات	و المتفجرات
والمتقاعدين	و المتقاعدين
والمتلاحقة	والمتلاحقة والمتلاحقة
والمتهم	و المتهم
والمتهمين	و المتهمين
والمتوازن	و المتوازن
والمتوسط	و المتوسط
والمتوسطة	و المتوسطة
والمتوفرة	و المتوفرة
والمتوقعة	و المتوقعة
والمثابرة	و المثابرة
والمثال	والمثال والمثال
والمثقفين	و المثقفين
والمجازر	و المجازر
والمجالات	و المجالات
والمجتمع	و المجتمع
والمجتمعات	و المجتمعات
والمجر	و المجر
والمجرمين	و المجرمين
والمجفف	و المجفف
والمجلس	والمجلس والمجلس
والمجموعات	و المجموعات
والمجوهرات	و المجوهرات
والمحاصيل	و المحاصيل
والمحاضرات	و المحاضرات
والمحافظ	و المحافظ
والمحافظات	و المحافظات
والمحافظة	و المحافظة
والمحامي	والمحامي والمحامي
والمحبة	و المحبة
والمحرج	و المحرج
والمحطات	و المحطات
والمحلي	و المحلي
والمحليات	و المحليات
والمحور	و المحور
والمخاطر	و المخاطر
والمخالفة	و المخالفة
والمخاوف	و المخاوف
والمخربون	و المخربون
والمدارس	و المدارس
والمدرسين	و المدرسين
والمدرعات	و المدرعات
والمدن	و المدن
والمدنيين	و المدنيين
والمدهش	و المدهش
والمدير	و المدير
والمدينة	و المدينة
والمرأة	و المرأة
والمراتب	والمراتب والمراتب
والمرافق	و المرافق
والمراقبة	و المراقبة
والمراكز	و المراكز
والمراهقات	و المراهقات
والمراوح	والمراوح والمراوح
والمرة	و المرة
والمرتبات	و المرتبات
والمرتهنين	و المرتهنين
والمرشحين	و المرشحين
والمرضى	و المرضى
والمركبات	و المركبات
والمزارعين	و المزارعين
والمزرعة	والمزرعة والمزرعة
والمزودة	و المزودة
والمزيد	و المزيد
والمسؤوليات	و المسؤوليات
والمسؤولين	و المسؤولين
والمساءلة	و المساءلة
والمساجد	و المساجد
والمساحات	و المساحات
والمساعدات	و المساعدات
والمساعدة	و المساعدة
والمساواة	و المساواة
والمستثمرين	و المستثمرين
والمستشار	و المستشار
والمستشفيات	و المستشفيات
والمستقبل	و المستقبل
والمستقبلي	و المستقبلي
والمستقبلية	و المستقبلية
والمستقلة	و المستقلة
والمستقلين	و المستقلين
والمستلزمات	و المستلزمات
والمستندات	و المستندات
والمستهتر	و المستهتر
والمستهلك	و المستهلك
والمستهلكة	و المستهلكة
والمستهلكين	و المستهلكين
والمستورد	و المستورد
والمستوردة	و المستوردة
والمستوردين	و المستوردين
والمستوى	و المستوى
والمسجد	و المسجد
والمسرحيين	و المسرحيين
والمسروقة	و المسروقة
والمسكن	و المسكن
والمسكنات	و المسكنات
والمسلمات	و المسلمات
والمسلمين	و المسلمين
والمسيحية	و المسيحية
والمسيحيين	و المسيحيين
والمشاركة	و المشاركة
والمشاركون	و المشاركون
والمشاريع	والمشاريع والمشاريع
والمشاكل	و المشاكل
والمشتبهين	و المشتبهين
والمشرب	و المشرب
والمشرف	و المشرف
والمشروبات	و المشروبات
والمشروع	و المشروع
والمشروعات	و المشروعات
والمشغولات	و المشغولات
والمشوهين	و المشوهين
والمصابين	و المصابين
والمصادرة	و المصادرة
والمصارف	و المصارف
والمصالح	و المصالح
والمصانع	و المصانع
والمصاهرة	و المصاهرة
والمصداقية	و المصداقية
والمصدرين	و المصدرين
والمصري	و المصري
والمصرية	و المصرية
والمصريين	و المصريين
والمصقول	و المصقول
والمصنعين	و المصنعين
والمصنوعات	و المصنوعات
والمضاربون	و المضاربون
والمضامين	و المضامين
والمضخات	و المضخات
والمطارات	و المطارات
والمطاطية	و المطاطية
والمطاعم	و المطاعم
والمطالب	و المطالب
والمطالبة	و المطالبة
والمعادن	و المعادن
والمعادي	و المعادي
والمعارض	و المعارض
والمعارضة	و المعارضة
والمعاشات	و المعاشات
والمعالم	و المعالم
والمعاملة	و المعاملة
والمعايير	و المعايير
والمعتقلين	و المعتقلين
والمعتمرين	والمعتمرين والمعتمرين
والمعدات	و المعدات
والمعدية	و المعدية
والمعراج	و المعراج
والمعروضة	و المعروضة
والمعروف	و المعروف
والمعلمين	و المعلمين
والمعلوم	و المعلوم
والمعلومات	و المعلومات
والمعنوية	و المعنوية
والمعيدين	و المعيدين
والمعيشي	والمعيشي والمعيشي
والمغالاة	و المغالاة
والمغالطات	والمغالطات والمغالطات
والمغرب	و المغرب
والمفاوضات	و المفاوضات
والمفتي	والمفتي والمفتي
والمفروشات	و المفروشات
والمفروض	و المفروض
والمفقودين	و المفقودين
والمفكر	و المفكر
والمفوضية	و المفوضية
والمقابر	و المقابر
والمقابلات	و المقابلات
والمقارنة	و المقارنة
والمقامة	و المقامة
والمقاولات	و المقاولات
والمقاولون	و المقاولون
والمقاولين	و المقاولين
والمقاومة	و المقاومة
والمقاومين	و المقاومين
والمقاييس	و المقاييس
والمقترحات	و المقترحات
والمقدسات	و المقدسات
والمقدم	و المقدم
والمقرر	و المقرر
والمقطوعات	والمقطوعات والمقطوعات
والمقطوعة	و المقطوعة
والمقومات	و المقومات
والمقيم	و المقيم
والمكان	و المكان
والمكاييل	والمكاييل والمكاييل
والمكتبات	و المكتبات
والمكتبة	والمكتبة والمكتبة
والمكر	و المكر
والمكونات	و المكونات
والملابس	و الملابس
والملاحظات	و الملاحظات
والملاذ	والملاذ والملاذ
والملاريا	والملاريا والملاريا
والملجأ	والملجأ والملجأ
والملك	و الملك
والملكة	و الملكة
والملكوت	والملكوت والملكوت
والملكية	و الملكية
والمليون	و المليون
والممتلكات	و الممتلكات
والممثل	والممثل والممثل
والممرضات	و الممرضات
والمملكة	و المملكة
والمنازعات	و المنازعات
والمناسبة	و المناسبة
والمناطق	و المناطق
والمنافـــع	والمنافـــع والمنافـــع
والمنتج	و المنتج
والمنتجات	و المنتجات
والمنتديات	و المنتديات
والمنح	و المنح
والمنزلية	و المنزلية
والمنسق	و المنسق
والمنسوجات	و المنسوجات
والمنطقة	و المنطقة
والمنظمات	و المنظمات
والمنوعة	و المنوعة
والمهالك	و المهالك
والمهج	والمهج والمهج
والمهم	والمهم والمهم
والمهندس	و المهندس
والمهندسين	و المهندسين
والمواد	و المواد
والموارد	و الموارد
والموازنة	و الموازنة
والمواصلات	و المواصلات
والمواقع	و المواقع
والمواليد	و المواليد
والموالين	و الموالين
والموانئ	و الموانئ
والمودة	و المودة
والموردين	و الموردين
والموروث	و الموروث
والموزعين	و الموزعين
والموصلات	و الموصلات
والموضوع	والموضوع والموضوع
والموضوعات	و الموضوعات
والموضوعية	و الموضوعية
والموقف	و الموقف
والمياه	و المياه
والميراث	و الميراث
والميزة	و الميزة
والنائب	و النائب
والنائبة	والنائبة والنائبة
والنادرة	و النادرة
والناس	و الناس
والناصر	والناصر والناصر
والناصريون	و الناصريون
والنباتات	و النباتات
والنبي	و النبي
والنتيجة	و النتيجة
والنجف	و النجف
والنحاس	و النحاس
والندوات	و الندوات
والنروج	والنروج والنروج
والنزاعات	والنزاعات والنزاعات
والنساء	و النساء
والنسيج	و النسيج
والنسيجية	و النسيجية
والنشادر	و النشادر
والنشاط	و النشاط
والنص	و النص
والنصف	و النصف
والنظام	و النظام
والنظر	والنظر والنظر
والنفاق	و النفاق
والنفط	و النفط
والنفطي	و النفطي
والنفـــوذ	والنفـــوذ والنفـــوذ
والنقدي	و النقدي
والنقدية	و النقدية
والنقض	و النقض
والنقل	و النقل
والنمسا	و النمسا
والنمسوي	والنمسوي والنمسوي
والنمو	و النمو
والنهوض	و النهوض
والنوع	و النوع
والنيجيري	و النيجيري
والهبوط	و الهبوط
والهجرة	و الهجرة
والهدايا	و الهدايا
والهدف	و الهدف
والهدوء	و الهدوء
والهزيمة	و الهزيمة
والهمم	و الهمم
والهند	و الهند
والهندسية	و الهندسية
والهوية	و الهوية
والهيئات	و الهيئات
والهيئة	و الهيئة
والهيروين	و الهيروين
والهيليوم	و الهيليوم
والواجبات	و الواجبات
والواردات	و الواردات
والوافدين	و الوافدين من
والواقع	و الواقع
والوثائق	و الوثائق
والوجبات	والوجبات والوجبات
والوجهة	و الوجهة
والوجود	و الوجود
والوحدات	و الوحدات
والوحدة	و الوحدة
والودائع	و الودائع
والورق	و الورق
والوزارات	و الوزارات
والوزارة	و الوزارة
والوزراء	و الوزراء
والوزير	و الوزير
والوسط	و الوسط
والوسطى	والوسطى والوسطى
والوصول	و الوصول
والوضع	و الوضع
والوضوح	و الوضوح
والوطن	و الوطن
والوطني	و الوطني
والوعي	والوعي والوعي
والوفاق	والوفاق والوفاق
والوفد	و الوفد
والوقاية	و الوقاية
والوقت	و الوقت
والوقود	و الوقود
والوقوف	و الوقوف
والوكالة	و الوكالة
والوكرة	والوكرة والوكرة
والولايات	و الولايات
والى	و إلى
واليابان	و اليابان
والياباني	و الياباني
واليسار	و اليسار
واليمن	و اليمن
واليمين	واليمين واليمين
والين	والين والين
واليهود	و اليهود
واليورو	و اليورو
واليوم	و اليوم
واليونانيون	و اليونانيون
واما	و أما
واماكن	و أماكن
وامام	و أمام
وامتلأ	و امتلأ
وامتناع	و امتناع
وامتنع	و امتنع
وامتنعت	و امتنعت
وامته	وامته وامته وامته
وامتهان	و امتهان
وامراض	و أمراض
وامريكا	و أمريكا
وامل	وامل وامل
وامن	و أمن
وامنية	و أمنية
وامه	وامه وامه وامه
وامهات	و أمهات
وامير	و أمير
واميركا	و أميركا
واميركيون	و أميركيون
واميل	و إميل
وامين	و أمين
وان	و أن
وانا	وانا وانا
واناء	و إناء
وانتاج	و إنتاج
وانتاجيتنا	وانتاجيتنا وانتاجيتنا وانتاجيتنا
وانتخاب	و انتخاب
وانتخابات	و انتخابات
وانتدابهم	و انتداب هم
وانترنت	و إنترنت
وانتشار	و انتشار
وانتشلت	و انتشلت
وانتظار	و انتظار
وانتظاراً	و انتظارا
وانتظر	و انتظر
وانتعشت	و انتعشت
وانتقال	و انتقال
وانتقد	و انتقد
وانتقدوا	و انتقدوا
وانتقل	و انتقل
وانتقلت	و انتقلت
وانتهاء	و انتهاء
وانتهاج	و انتهاج
وانتهاك	وانتهاك وانتهاك
وانتهاكا	و انتهاكا
وانتهاكات	و انتهاكات
وانتهت	و انتهت
وانتهى	و انتهى
وانجازات	و إنجازات
وانجزت	و أنجزت
وانخفاض	و انخفاض
وانخفاضه	و انخفاض ه
واندلاع	و اندلاع
واندورا	و أندورا
واندونيسيا	و إندونيسيا
وانسحاب	و انسحاب
وانشاء	و إنشاء
وانشد	و أنشد
وانشغل	و انشغل
وانضباطا	و انضباطا
وانضمام	و انضمام
وانطلاقاً	و انطلاقا
وانطلقت	و انطلقت
وانعاش	و إنعاش
وانعكاساتها	و انعكاسات ها
وانعكست	و انعكست
وانغولا	و أنغولا
وانفجار	وانفجار وانفجار
وانفجرت	و انفجرت
وانفقت	و أنفقت
وانفها	و أنف ها
وانقرة	و أنقرة
وانقطاع	وانقطاع وانقطاع
وانكلترا	وانكلترا وانكلترا
وانما	و إنما
واننا	واننا واننا واننا
وانه	و أن ه
وانها	و أن ها
وانهاء	و إنهاء
وانهم	و إن هم
وانهيار	و انهيار
واوربا	و أوربا
واوردت	و أوردت
واورلاندو	و أورلاندو
واوروبا	و أوروبا
واوزبكستان	واوزبكستان واوزبكستان
واوضاعه	واوضاعه واوضاعه واوضاعه
واوضح	و أوضح
واوضحت	و أوضحت
واوضحوا	و أوضحوا
واوغندا	و أوغندا
واوكرانيا	واوكرانيا واوكرانيا
واي	واي واي
وايابا	و إيابا
واياد	واياد واياد
وايجابية	وايجابية وايجابية
وايجاد	و إيجاد
وايران	و إيران
وايراني	و إيراني
وايسلندا	وايسلندا وايسلندا
وايصاله	و إيصال ه
وايضا	و أيضا
وايطاليا	و إيطاليا
وايقاف	و إيقاف
وايلول	و أيلول
واين	و أين
وايهما	وايهما وايهما وايهما
وبأسعار	و ب أسعار
وبأقل	و ب أقل
وبأنها	و ب أن ها
وبإطلاق	و ب إطلاق
وبات	و بات
وباتت	و باتت
وباختصار	و ب اختصار
وباراك	و باراك
وباستثمارات	و ب استثمارات
وباستثناء	و ب استثناء
وباسعار	و ب أسعار
وباشرتا	و باشرتا
وباشروا	و باشروا
وباقي	و باقي
وباكستان	و باكستان
وباكو	و باكو
وبالاعتماد	و ب الاعتماد
وبالتالي	و ب التالي
وبالتحديد	و ب التحديد
وبالتشاور	و ب التشاور
وبالتعاون	و ب التعاون
وبالتوازي	و ب التوازي
وبالحصول	و ب الحصول
وبالذات	و ب الذات
وبالرغم	و ب الرغم
وبالطبع	و ب الطبع
وبالعودة	و ب العودة
وبالغ	و بالغ
وبالفعل	و ب الفعل
وبالقرب	و ب القرب
وبالمقابل	و ب المقابل
وبالمناسبة	و ب المناسبة
وبالنسبة	و ب النسبة
وبالوقوف	و ب الوقوف
وبامكانه	و ب إمكان ه
وبان	و ب أن
وبانطلاق	و ب انطلاق
وبانه	و ب أن ه
وباول	و باول
وببرنامجها	و ب برنامج ها
وببلدنا	وببلدنا وببلدنا وببلدنا وببلدنا
وبتسهيلات	و ب تسهيلات
وبتطوير	و ب تطوير
وبتغطية	و ب تغطية
وبتكلفة	و ب تكلفة
وبتلك	و ب تلك
وبتوجهاتنا	وبتوجهاتنا وبتوجهاتنا وبتوجهاتنا وبتوجهاتنا
وبجلبهم	و ب جلب هم
وبجهاز	و ب جهاز
وبحث	و بحث
وبحسب	و ب حسب
وبحضور	و ب حضور
وبحلول	و ب حلول
وبحوزة	و ب حوزة
وبحوزته	و ب حوزة ه
وبحوزتهم	و ب حوزة هم
وبخاصة	و ب خاصة
وبخلاف	و ب خلاف
وبدء	و بدء
وبدأ	و بدأ
وبدأت	و بدأت
وبدأوا	و بدؤوا
وبدا	و بدا
وبداية	و بداية
وبدر	وبدر وبدر
وبدعم	و ب دعم
وبدلاً	و بدلا
وبدوره	و ب دور ه
وبدورهم	و ب دور هم
وبدون	و ب دون
وبديلا	و بديلا
وبذا	و ب ذا
وبذرة	و بذرة
وبذريعة	و ب ذريعة
وبذلك	و ب ذٰلك
وبذور	و بذور
وبرأت	و برأت
وبرامج	و برامج
وبرر	و برر
وبرزت	و برزت
وبرصد	و ب رصد
وبرفقته	و ب رفقة ه
وبرلماناً	وبرلمانا وبرلمانا
وبروزهم	و بروز هم
وبريطانيا	و بريطانيا
وبريطانية	و بريطانية
وبزيادة	و ب زيادة
وبسبب	و ب سبب
وبسعر	و ب سعر
وبسيطة	و بسيطة
وبشأن	و ب شأن
وبشار	وبشار وبشار
وبشدة	وبشدة وبشدة وبشدة
وبشرته	و بشرة ه
وبشرط	و ب شرط
وبشرى	وبشرى وبشرى
وبشكل	و ب شكل
وبصر	وبصر وبصر
وبصفة	و ب صفة
وبصورة	و ب صورة
وبضع	و بضع
وبطاقة	و ب طاقة
وبطريقة	و ب طريقة
وبطولات	و بطولات
وبطولة	و بطولة
وبعث	و بعث
وبعد	و بعد
وبعدما	و بعدما
وبعده	و بعد ه
وبعدها	و بعد ها
وبعض	و بعض
وبعضها	و بعض ها
وبعضهم	و بعض هم
وبعلاقتهم	و ب علاقة هم
وبعيداً	و بعيدا
وبغداد	وبغداد وبغداد
وبفائدة	و ب فائدة
وبفضل	و ب فضل
وبقى	و بقي
وبقي	و بقي
وبقيام	و ب قيام
وبقية	و بقية
وبقيت	و بقيت
وبكثير	وبكثير وبكثير وبكثير
وبكر	وبكر وبكر
وبكى	و بكى
وبكين	و بكين
وبلا	و ب لا
وبلاد	و بلاد
وبلاش	و بلاش
وبلجيكا	و بلجيكا
وبلدة	و بلدة
وبلدية	و بلدية
وبلغ	و بلغ
وبلغاريا	و بلغاريا
وبلغت	و بلغت
وبلور	و بلور
وبلوزات	وبلوزات وبلوزات
وبليوني	و بليوني
وبمؤسساتها	و ب مؤسسات ها
وبما	و ب ما
وبمبررات	و ب مبررات
وبمرونة	و ب مرونة
وبمعزل	و ب معزل
وبمقتضى	و ب مقتضى
وبمقدورها	و ب مقدور ها
وبموازاة	و ب موازاة
وبموجب	و ب موجب
وبموضوع	و ب موضوع
وبن	وبن وبن
وبناء	و بناء
وبنصف	و ب نصف
وبنغلادش	وبنغلادش وبنغلادش
وبنفس	و ب نفس
وبنك	و بنك
وبنوع	و ب نوع
وبنوك	و بنوك
وبنية	و بنية
وبه	و ب ه
وبهتاناً	و بهتانا
وبهدف	و ب هدف
وبهذا	و ب هٰذا
وبهيج	وبهيج وبهيج
وبواقع	و ب واقع
وبوتائر	و ب وتائر
وبور	و بور
وبورتلاند	و بورتلاند
وبورسعيد	و بورسعيد
وبوروندي	وبوروندي وبوروندي
وبوسع	و ب وسع
وبوش	و بوش
وبوضوح	و ب وضوح
وبولندا	و بولندا
وبوليفيا	و بوليفيا
وبيئته	وبيئته وبيئته وبيئته
وبيانات	و بيانات
وبيت	و بيت
وبيروت	و بيروت
وبيشاور	و بيشاور
وبيض	و بيض
وبيع	و بيع
وبيعها	و بيع ها
وبيفيرلي	و بيفيرلي
وبين	و بين
وبينت	و بينت
وبينك	و بين ك
وبينما	و بينما
وبينهم	و بين هم
وبيوت	و بيوت
وتأتي	و تأتي
وتأثرت	و تأثرت
وتأثيرات	و تأثيرات
وتأثيرها	و تأثير ها
وتأجلت	و تأجلت
وتأجير	و تأجير
وتأجيل	و تأجيل
وتأديب	و تأديب
وتأسس	و تأسس
وتأسست	و تأسست
وتألفت	و تألفت
وتأليف	و تأليف
وتأمل	و تأمل
وتأهيل	و تأهيل
وتأييده	و تأييد ه
وتؤدى	و تؤدى
وتؤرق	و تؤرق
وتؤكد	و تؤكد
وتؤيد	و تؤيد
وتابع	و تابع
وتابعت	و تابعت
وتابعوا	و تابعوا
وتاريخها	وتاريخها وتاريخها وتاريخها
وتاليا	و تاليا
وتانيا	و تانيا
وتايوان	و تايوان
وتبادل	و تبادل
وتبادلت	و تبادلت
وتبحث	و تبحث
وتبدأ	و تبدأ
وتبذل	و تبذل
وتبذير	و تبذير
وتبرز	و تبرز
وتبسيط	و تبسيط
وتبقي	و تبقي
وتبلغ	و تبلغ
وتبنتها	و تبنت ها
وتبني	وتبني وتبني
وتبين	و تبين
وتتآكل	و تتآكل
وتتأهب	و تتأهب
وتتبين	و تتبين
وتتجسد	و تتجسد
وتتحمل	و تتحمل
وتتخذ	و تتخذ
وتتخصص	و تتخصص
وتتخوف	و تتخوف
وتتدفق	و تتدفق
وتتراكم	و تتراكم
وتتراوح	و تتراوح
وتتسبب	و تتسبب
وتتسلم	و تتسلم
وتتسم	و تتسم
وتتشكل	و تتشكل
وتتصاعد	و تتصاعد
وتتضمن	و تتضمن
وتتطلب	و تتطلب
وتتعاون	و تتعاون
وتتعدد	و تتعدد
وتتعرض	و تتعرض
وتتعمق	و تتعمق
وتتعمّق	و تتعمق
وتتقدم	و تتقدم
وتتكفل	و تتكفل
وتتكون	و تتكون
وتتلاقى	وتتلاقى وتتلاقى
وتتم	و تتم
وتتمتع	و تتمتع
وتتمثل	و تتمثل
وتتميز	و تتميز
وتتنصل	و تتنصل
وتتهددها	و تتهدد ها
وتتهم	و تتهم
وتتوجه	و تتوجه
وتتوقع	و تتوقع
وتتولى	و تتولى
وتتولي	و تتولى
وتتيح	و تتيح
وتثبيت	و تثبيت
وتثبيته	و تثبيت ه
وتثير	و تثير
وتجارب	و تجارب
وتجارة	و تجارة
وتجاوبت	و تجاوبت
وتجاوز	و تجاوز
وتجاوزت	و تجاوزت
وتجتذب	و تجتذب
وتجدر	و تجدر
وتجديد	و تجديد
وتجرى	و تجرى
وتجري	و تجري
وتجعلها	و تجعل ها
وتجمعات	و تجمعات
وتجمعوا	و تجمعوا
وتجميع	و تجميع
وتجنب	و تجنب
وتجنّب	و تجنب
وتجول	و تجول
وتحاول	و تحاول
وتحايل	وتحايل وتحايل
وتحت	و تحت
وتحتاج	و تحتاج
وتحتجز	و تحتجز
وتحترم	و تحترم
وتحتل	و تحتل
وتحث	و تحث
وتحدث	و تحدث
وتحدثت	و تحدثت
وتحدثنا	وتحدثنا وتحدثنا
وتحديد	و تحديد
وتحديدا	و تحديدا
وتحديداً	و تحديدا
وتحرر	وتحرر وتحرر
وتحرياتهم	و تحريات هم
وتحريض	و تحريض
وتحريف	و تحريف
وتحسين	و تحسين
وتحشر	و تحشر
وتحصر	و تحصر
وتحصيل	و تحصيل
وتحصيلها	و تحصيل ها
وتحضير	و تحضير
وتحضيراً	و تحضيرا
وتحطم	و تحطم
وتحظى	و تحظى
وتحف	وتحف وتحف
وتحفظ	و تحفظ
وتحقق	وتحقق وتحقق
وتحقير	و تحقير
وتحقيق	و تحقيق
وتحلق	و تحلق
وتحلية	وتحلية وتحلية
وتحليق	و تحليق
وتحليل	و تحليل
وتحمل	و تحمل
وتحمي	و تحمي
وتحميل	و تحميل
وتحميلها	وتحميلها وتحميلها وتحميلها
وتحمّل	و تحمل
وتحوز	و تحوز
وتحول	و تحول
وتحولت	و تحولت
وتحويل	و تحويل
وتحويلها	و تحويل ها
وتحيا	وتحيا وتحيا
وتختتم	و تختتم
وتختلف	و تختلف
وتخزين	و تخزين
وتخشى	و تخشى
وتخصيص	و تخصيص
وتخطط	و تخطط
وتخفف	و تخفف
وتخفيض	و تخفيض
وتخفيف	و تخفيف
وتخلي	وتخلي وتخلي
وتداعيات	و تداعيات
وتداول	و تداول
وتداوله	و تداول ه
وتداولوا	و تداولوا
وتدخلت	و تدخلت
وتدرس	و تدرس
وتدرك	و تدرك
وتدريب	و تدريب
وتدشين	و تدشين
وتدعو	و تدعو
وتدعى	و تدعى
وتدفق	و تدفق
وتدفقات	و تدفقات
وتدمر	و تدمر
وتدمير	و تدمير
وتدني	وتدني وتدني
وتدهور	و تدهور
وتدور	و تدور
وتدين	و تدين
وتذليل	و تذليل
وتراجع	و تراجع
وتراجعت	و تراجعت
وتراجعه	و تراجع ه
وترافق	و ترافق
وتراكمت	و تراكمت
وتراوح	و تراوح
وتربط	و تربط
وتربكها	و تربك ها
وترتبط	و ترتبط
وترتفع	و ترتفع
وترتيب	و ترتيب
وترتيبا	و ترتيبا
وترجم	و ترجم
وترحب	و ترحب
وترحيل	و ترحيل
وتردد	و تردد
وترسيخ	وترسيخ وترسيخ
وترسيخه	و ترسيخ ه
وترشيد	و ترشيد
وترشيدها	وترشيدها وترشيدها وترشيدها
وترغب	و ترغب
وترك	و ترك
وتركز	و تركز
وتركزت	و تركزت
وتركيا	و تركيا
وتركيز	و تركيز
وتركيزه	و تركيز ه
وترميمها	و ترميم ها
وترويج	و ترويج
وترويع	وترويع وترويع
وترى	و ترى
وتزامن	و تزامن
وتزامنا	و تزامنا
وتزايد	و تزايد
وتزداد	و تزداد
وتزود	و تزود
وتزيد	و تزيد
وتزيين	و تزيين
وتساءل	و تساءل
وتساءلت	و تساءلت
وتسانده	و تساند ه
وتساوم	و تساوم
وتسبب	و تسبب
وتسببها	و تسبب ها
وتسببوا	و تسببوا
وتستأثر	و تستأثر
وتستحق	و تستحق
وتستطيع	و تستطيع
وتستعد	و تستعد
وتستمر	و تستمر
وتستند	و تستند
وتستهدف	و تستهدف
وتسريع	و تسريع
وتسعى	و تسعى
وتسلم	و تسلم
وتسليم	و تسليم
وتسليمات	و تسليمات
وتسمح	و تسمح
وتسمحان	و تسمحان
وتسهيل	و تسهيل
وتسوق	و تسوق
وتسوية	و تسوية
وتسويق	و تسويق
وتسويقها	و تسويق ها
وتسير	و تسير
وتشاد	و تشاد
وتشارك	و تشارك
وتشاينا	و تشاينا
وتشترك	و تشترك
وتشجع	و تشجع
وتشجيع	و تشجيع
وتشجيعهم	و تشجيع هم
وتشغله	و تشغل ه
وتشغيل	و تشغيل
وتشغيلها	و تشغيل ها
وتشكل	و تشكل
وتشكيل	و تشكيل
وتشكيلات	وتشكيلات وتشكيلات
وتشمل	و تشمل
وتشن	و تشن
وتشهد	و تشهد
وتشير	و تشير
وتشييد	و تشييد
وتصاعد	و تصاعد
وتصدت	و تصدت
وتصدر	و تصدر
وتصدرت	و تصدرت
وتصدير	و تصدير
وتصديراً	و تصديرا
وتصديره	و تصدير ه
وتصديرها	و تصدير ها
وتصر	و تصر
وتصرفات	و تصرفات
وتصفية	و تصفية
وتصل	و تصل
وتصميم	و تصميم
وتصنيع	و تصنيع
وتصنيعاً	و تصنيعا
وتصون	وتصون وتصون
وتصوير	و تصوير
وتضاربت	و تضاربت
وتضاعفت	و تضاعفت
وتضامن	وتضامن وتضامن
وتضع	و تضع
وتضم	و تضم
وتضمن	و تضمن
وتضمنت	و تضمنت
وتضيف	وتضيف وتضيف
وتطالب	و تطالب
وتطرق	و تطرق
وتطرقوا	و تطرقوا
وتطلب	و تطلب
وتطلع	و تطلع
وتطلق	و تطلق
وتطور	و تطور
وتطوير	و تطوير
وتطويرها	و تطوير ها
وتظهر	و تظهر
وتعادل	و تعادل
وتعالت	و تعالت
وتعالى	و تعالى
وتعاني	و تعاني
وتعاون	و تعاون
وتعبر	و تعبر
وتعتبر	و تعتبر
وتعتبره	و تعتبر ه
وتعترف	و تعترف
وتعتزم	و تعتزم
وتعتقد	و تعتقد
وتعجز	و تعجز
وتعد	و تعد
وتعديل	و تعديل
وتعذر	و تعذر
وتعرب	و تعرب
وتعرض	و تعرض
وتعرضت	و تعرضت
وتعرف	و تعرف
وتعريف	و تعريف
وتعريفهم	و تعريف هم
وتعزز	و تعزز
وتعزيز	و تعزيز
وتعظيم	و تعظيم
وتعقد	و تعقد
وتعكس	و تعكس
وتعكف	و تعكف
وتعلن	و تعلن
وتعليـق	و تعليق
وتعليمات	و تعليمات
وتعمل	و تعمل
وتعميرها	و تعمير ها
وتعميق	و تعميق
وتعهد	و تعهد
وتعويض	و تعويض
وتعيد	وتعيد وتعيد
وتغطية	و تغطية
وتغطيتها	وتغطيتها وتغطيتها وتغطيتها
وتغلب	و تغلب
وتغلق	و تغلق
وتغير	و تغير
وتغيير	و تغيير
وتفادي	و تفادي
وتفاصيل	و تفاصيل
وتفاعل	وتفاعل وتفاعل
وتفاقمت	و تفاقمت
وتفريغ	و تفريغ
وتفريقه	و تفريق ه
وتفصلهما	وتفصلهما وتفصلهما وتفصلهما
وتفصيل	و تفصيل
وتفضيلهم	و تفضيل هم
وتفعيل	و تفعيل
وتفعيلها	و تفعيل ها
وتفكيك	و تفكيك
وتفويض	و تفويض
وتقاوم	و تقاوم
وتقاوي	و تقاوي
وتقترح	و تقترح
وتقتل	و تقتل
وتقدر	و تقدر
وتقدم	و تقدم
وتقدمت	و تقدمت
وتقدير	و تقدير
وتقديره	و تقدير ه
وتقديم	و تقديم
وتقرر	و تقرر
وتقصف	و تقصف
وتقصي	وتقصي وتقصي
وتقضي	و تقضي
وتقطيع	و تقطيع
وتقع	و تقع
وتقليدي	و تقليدي
وتقليص	و تقليص
وتقليل	و تقليل
وتقنياته	و تقنيات ه
وتقول	و تقول
وتقوم	و تقوم
وتقويم	و تقويم
وتقيد	و تقيد
وتقيم	و تقيم
وتقيمه	و تقيم ه
وتقييم	و تقييم
وتكافؤ	و تكافؤ
وتكاليف	وتكاليف وتكاليف
وتكتسي	و تكتسي
وتكثيف	و تكثيف
وتكرار	و تكرار
وتكريس	وتكريس وتكريس
وتكريما	و تكريما
وتكلفة	و تكلفة
وتكليفه	و تكليف ه
وتكنولوجيا	و تكنولوجيا
وتكون	و تكون
وتكونت	و تكونت
وتكوين	و تكوين
وتل	و تل
وتلا	و تلا
وتلاحظ	و تلاحظ
وتلاحقهم	و تلاحق هم
وتلبية	و تلبية
وتلصق	و تلصق
وتلعب	و تلعب
وتلقت	و تلقت
وتلقم	و تلقم
وتلقوا	و تلقوا
وتلقى	و تلقى
وتلقي	و تلقى
وتلك	و تلك
وتلي	و تلي
وتليها	و تلي ها
وتم	و تم
وتمارس	و تمارس
وتمت	و تمت
وتمتلك	و تمتلك
وتمثل	و تمثل
وتمثلان	و تمثلان
وتمثلت	و تمثلت
وتمخض	و تمخض
وتمديداتها	و تمديدات ها
وتمركزها	و تمركز ها
وتمسك	و تمسك
وتمكنت	و تمكنت
وتمكين	و تمكين
وتمكينها	وتمكينها وتمكينها وتمكينها
وتمكينهن	و تمكين هن
وتملك	و تملك
وتمنع	و تمنع
وتمويل	و تمويل
وتميز	و تميز
وتناسب	و تناسب
وتنافس	و تنافس
وتنامت	و تنامت
وتنامي	وتنامي وتنامي
وتناوب	و تناوب
وتناول	و تناول
وتناولت	و تناولت
وتنتج	و تنتج
وتنحسر	و تنحسر
وتندد	و تندد
وتندرج	و تندرج
وتنزانيا	وتنزانيا وتنزانيا
وتنسيق	و تنسيق
وتنشيط	و تنشيط
وتنشيطها	و تنشيط ها
وتنص	و تنص
وتنظر	و تنظر
وتنظمه	و تنظم ه
وتنظيف	و تنظيف
وتنظيم	و تنظيم
وتنظيماتهم	و تنظيمات هم
وتنظيمية	و تنظيمية
وتنفثان	و تنفثان
وتنفيذ	و تنفيذ
وتنفيذها	و تنفيذ ها
وتنقية	و تنقية
وتنمية	و تنمية
وتنميته	و تنمية ه
وتنهي	و تنهي
وتنوعت	و تنوعت
وتنوعها	و تنوع ها
وتهبط	و تهبط
وتهدد	و تهدد
وتهددها	و تهدد ها
وتهدف	و تهدف
وتهمة	و تهمة
وتوابعها	و توابع ها
وتواجه	و تواجه
وتواصل	و تواصل
وتوافر	و توافر
وتوافق	و توافق
وتوترت	و توترت
وتوجد	و توجد
وتوجيه	و توجيه
وتوجيهات	و توجيهات
وتوحيد	و توحيد
وتوريثه	و توريث ه
وتوريد	و توريد
وتوريس	وتوريس وتوريس
وتوزيع	و توزيع
وتوزيعه	و توزيع ه
وتوسيع	و توسيع
وتوصياتها	و توصيات ها
وتوصيل	و توصيل
وتوطين	و توطين
وتوظيف	و توظيف
وتوفر	و توفر
وتوفى	و توفي
وتوفي	و توفي
وتوفير	و توفير
وتوقع	و توقع
وتوقعات	و توقعات
وتوقفت	و توقفت
وتوقيع	و توقيع
وتولت	و تولت
وتوليدها	و توليد ها
وتونس	و تونس
وتيبازه	و تيبازه
وتيرته	وتيرة ه
وتيرتها	وتيرتها وتيرتها
وتيسير	و تيسير
وتيسيرات	و تيسيرات
وثالثة	و ثالثة
وثاني	و ثاني
وثانياً	و ثانيا
وثانيها	و ثاني ها
وثانيهما	و ثاني هما
وثبات	و ثبات
وثباتا	و ثباتا
وثقافته	و ثقافة ه
وثقافي	و ثقافي
وثلاث	و ثلاث
وثلاثة	و ثلاثة
وثم	و ثم
وثمانية	و ثمانية
وثمة	و ثمة
وثوابتها	وثوابتها وثوابتها وثوابتها
وثورة	و ثورة
وجاء	و جاء
وجاءت	و جاءت
وجابت	و جابت
وجاري	وجاري وجاري
وجاكرتا	و جاكرتا
وجامع	و جامع
وجامعة	و جامعة
وجان	و جان
وجاهدوا	و جاهدوا
وجبار	وجبار وجبار
وجبناء	و جبناء
وجبهة	وجبهة وجبهة
وجدد	و جدد
وجدولة	و جدولة
وجديدة	و جديدة
وجدير	و جدير
وجدّد	و جدد
وجذب	و جذب
وجرائم	و جرائم
وجرائمه	و جرائم ه
وجرح	و جرح
وجرى	و جرى
وجريح	و جريح
وجزءاً	و جزءا
وجزائري	و جزائري
وجزر	و جزر
وجسدها	و جسد ها
وجعل	و جعل
وجعلت	و جعلت
وجغرافيتها	وجغرافيتها وجغرافيتها وجغرافيتها
وجلال	وجلال وجلال
وجلبها	و جلب ها
وجلس	و جلس
وجلسات	و جلسات
وجلـــسة	وجلـــسة وجلـــسة
وجمالية	وجمالية وجمالية
وجماليتها	و جمالية ها
وجمع	و جمع
وجمعيات	و جمعيات
وجمهورية	و جمهورية
وجميع	و جميع
وجندي	و جندي
وجنديا	و جنديا
وجنرال	وجنرال وجنرال
وجنوب	و جنوب
وجنوبه	و جنوب ه
وجنوبها	و جنوب ها
وجنود	و جنود
وجنينا	وجنينا وجنينا
وجهات	و جهات
وجهاز	و جهاز
وجهته	وجهت ه
وجهتها	وجهت ها
وجهتي	وجهتي وجهتي
وجهل	و جهل
وجهه	وجه ه
وجهها	وجه ها
وجو	و جو
وجواره	و جوار ه
وجودة	و جودة
وجودكم	وجود كم
وجوده	وجود ه
وجودها	وجود ها
وجودهم	وجود هم
وجودهما	وجود هما
وجورج	و جورج
وجورجيا	و جورجيا
وجون	و جون
وجوهانسبرج	وجوهانسبرج وجوهانسبرج
وجوههم	وجوههم وجوههم
وجيبوتي	و جيبوتي
وجيشه	و جيش ه
وحاتم	وحاتم وحاتم
وحاجبين	و حاجبين
وحازمة	و حازمة
وحاسمة	وحاسمة وحاسمة
وحاصرته	و حاصرت ه
وحال	و حال
وحالات	و حالات
وحالة	و حالة
وحالته	و حالة ه
وحالتها	و حالة ها
وحامض	و حامض
وحاول	و حاول
وحتى	و حتى
وحث	و حث
وحثت	و حثت
وحثها	و حث ها
وحجب	و حجب
وحجز	و حجز
وحجزوا	و حجزوا
وحجم	و حجم
وحدد	و حدد
وحددت	و حددت
وحددها	و حدد ها
وحده	وحد ه
وحدها	وحد ها
وحدهم	وحد هم
وحذر	و حذر
وحذرت	و حذرت
وحذروا	و حذروا
وحذّر	و حذر
وحرارة	وحرارة وحرارة
وحراسة	و حراسة
وحرب	و حرب
وحربا	و حربا
وحرر	و حرر
وحرصت	و حرصت
وحرق	و حرق
وحركة	و حركة
وحركها	و حرك ها
وحروب	و حروب
وحرية	و حرية
وحريته	وحريته وحريته وحريته
وحريّ	وحري وحري
وحزب	و حزب
وحزبي	و حزبي
وحساب	وحساب وحساب
وحسابات	و حسابات
وحسب	و حسب
وحسبما	و حسب ما
وحسمت	و حسمت
وحسن	و حسن
وحسنت	و حسنت
وحصار	و حصار
وحصان	و حصان
وحصل	و حصل
وحصلت	و حصلت
وحصن	و حصن
وحصول	و حصول
وحض	و حض
وحضارية	و حضارية
وحضر	و حضر
وحظر	و حظر
وحفز	و حفز
وحفظ	و حفظ
وحفلت	و حفلت
وحق	و حق
وحقائب	و حقائب
وحقق	و حقق
وحققت	و حققت
وحقه	و حق ه
وحقوق	و حقوق
وحقوقنا	وحقوقنا وحقوقنا وحقوقنا
وحكم	و حكم
وحكمته	و حكمة ه
وحكومة	و حكومة
وحكومته	و حكومة ه
وحل	و حل
وحلت	و حلت
وحلفاؤه	و حلفاء ه
وحلفائه	وحلفائه وحلفائه وحلفائه
وحلفائها	و حلفاء ها
وحلفائهم	و حلفاء هم
وحلقات	و حلقات
وحلوى	و حلوى
وحليف	و حليف
وحليفتاها	و حليفتا ها
وحماية	و حماية
وحمص	و حمص
وحمل	و حمل
وحملة	و حملة
وحملت	و حملت
وحوار	و حوار
وحوافز	و حوافز
وحول	و حول
وحياتكم	و حياة كم
وحيادهم	و حياد هم
وحيازة	و حيازة
وحيدر	وحيدر وحيدر
وحين	و حين
وحيوي	و حيوي
وخاتمي	وخاتمي وخاتمي
وخارج	و خارج
وخارجه	و خارج ه
وخارجها	و خارج ها
وخارجية	وخارجية وخارجية
وخارطة	و خارطة
وخاصة	و خاصة
وخاضت	و خاضت
وخاضع	وخاضع وخاضع
وخالد	وخالد وخالد
وخالص	و خالص
وخام	و خام
وخانة	وخانة وخانة
وخبراء	و خبراء
وخبرات	و خبرات
وخبرتها	و خبرة ها
وختان	و ختان
وختم	و ختم
وخدمات	و خدمات
وخدمة	و خدمة
وخدمية	و خدمية
وخرازي	وخرازي وخرازي
وخرج	و خرج
وخرجت	و خرجت
وخرجوا	و خرجوا
وخسائر	و خسائر
وخسارة	و خسارة
وخص	و خص
وخصخصة	و خصخصة
وخصص	و خصص
وخصمها	و خصم ها
وخصه	و خص ه
وخصوصا	و خصوصا
وخصوصاً	و خصوصا
وخصوصياتنا	وخصوصياتنا وخصوصياتنا وخصوصياتنا
وخضع	و خضع
وخضعا	و خضعا
وخطابه	و خطاب ه
وخطف	و خطف
وخطوات	و خطوات
وخطورتها	و خطورة ها
وخطيرة	وخطيرة وخطيرة
وخفض	و خفض
وخلافه	و خلاف ه
وخلال	و خلال
وخلدت	و خلدت
وخلص	و خلص
وخلع	و خلع
وخلعها	و خلع ها
وخلفائه	و خلفاء ه
وخلفه	و خلف ه
وخلق	و خلق
وخليل	وخليل وخليل
وخمس	و خمس
وخمسة	و خمسة
وخمسون	و خمسون
وخمسين	و خمسين
وخيارات	و خيارات
ود	و د
ودائعه	ودائع ه
ودائعهم	ودائع هم
ودائم	و دائم
وداخل	و داخل
ودافع	و دافع
ودالاس	و دالاس
ودخل	و دخل
ودخلت	و دخلت
ودخولها	و دخول ها
ودراجة	و دراجة
ودرجات	و درجات
ودرجة	و درجة
ودرس	و درس
ودروس	و دروس
ودعا	و دعا
ودعاهن	و دعا هن
ودعت	و دعت
ودعم	و دعم
ودعوا	و دعوا
ودعوتهم	و دعوة هم
ودعوه	و دعوا ه
ودفع	و دفع
ودفعت	و دفعت
ودفعها	و دفع ها
ودفعهم	و دفع هم
ودقيقة	و دقيقة
ودلت	و دلت
ودمج	و دمج
ودمجهما	ودمجهما ودمجهما ودمجهما
ودمر	و دمر
ودمرت	و دمرت
ودمشق	و دمشق
ودوافعك	و دوافع ك
ودور	و دور
ودوري	و دوري
ودورياتها	و دوريات ها
ودول	و دول
ودولاً	و دولا
ودولة	و دولة
ودولية	و دولية
ودون	و دون
وديبلوماسية	و ديبلوماسية
وديمقراطى	و ديمقراطي
وديموقراطية	و ديموقراطية
ودينه	و دين ه
ودينى	و ديني
ودينية	و دينية
وذات	و ذات
وذخيرة	و ذخيرة
وذرياتهم	و ذريات هم
وذكر	و ذكر
وذكرت	و ذكرت
وذكّر	و ذكر
وذلك	و ذٰلك
وذهب	و ذهب
وذهبوا	و ذهبوا
وذهل	و ذهل
وذي	و ذي
ورأت	و رأت
ورأس	و رأس
ورأى	و رأى
ورؤساء	و رؤساء
ورئاسة	و رئاسة
ورئيس	و رئيس
ورئيسات	ورئيسات ورئيسات
ورئيسة	ورئيسة ورئيسة
وراءه	وراء ه
ورائه	وراء ه
ورابطة	و رابطة
ورابعهم	و رابع هم
وراح	و راح
وراى	و رأى
وربط	و ربط
وربطها	وربطها وربطها وربطها
وربع	و ربع
وربما	و ربما
ورثاثتها	ورثاثتها ورثاثتها ورثاثتها
ورثها	ورث ها
ورجاء	ورجاء ورجاء
ورجال	و رجال
ورجاله	و رجال ه
ورجح	و رجح
ورجحت	و رجحت
ورجل	و رجل
ورحب	و رحب
ورحلات	و رحلات
ورحلة	و رحلة
ورد	و رد
وردا	و ردا
ورداً	و ردا
وردد	و ردد
وردها	وردها وردها وردها
ورسائل	و رسائل
ورسوم	و رسوم
ورسومات	و رسومات
ورش	و رش
ورشقوه	و رشقوا ه
ورصد	و رصد
ورصداً	و رصدا
ورصدـ	و رصد
ورعاها	و رعى ها
ورعاية	و رعاية
ورغبات	ورغبات ورغبات
ورغم	و رغم
ورفاقه	و رفاق ه
ورفح	و رفح
ورفض	و رفض
ورفضت	و رفضت
ورفضته	و رفضت ه
ورفضوا	و رفضوا
ورفع	و رفع
ورفعت	و رفعت
ورفعوا	و رفعوا
ورفيق	ورفيق ورفيق
وركز	و ركز
وركود	و ركود
ورمضان	ورمضان ورمضان
ورمل	و رمل
وروحها	وروحها وروحها وروحها
وروسيا	و روسيا
ورومانيا	و رومانيا
وريتشارد	و ريتشارد
وزاد	و زاد
وزادت	و زادت
وزار	و زار
وزارته	وزارة ه
وزايد	وزايد وزايد
وزجاجات	و زجاجات
وزراءه	وزراء ه
وزرائه	وزراء ه
وزعزعة	و زعزعة
وزعها	وزع ها
وزعيم	و زعيم
وزقاقيين	و زقاقيين
وزملاء	و زملاء
وزملاؤه	و زملاء ه
وزملائه	و زملاء ه
وزمن	و زمن
وزميله	و زميل ه
وزنزبار	وزنزبار وزنزبار
وزنها	وزن ها
وزهدي	وزهدي وزهدي
وزهراء	و زهراء
وزهير	وزهير وزهير
وزوجته	و زوجة ه
وزيادة	و زيادة
وزيادتها	و زيادة ها
وزيارات	و زيارات
وزيارة	و زيارة
وزير	وزير الطاقة
وزين	و زين
وزيوت	و زيوت
وسأخوض	وسأخوض وسأخوض وسأخوض
وسأسعى	وسأسعى وسأسعى وسأسعى
وسأكون	وسأكون وسأكون وسأكون
وسأل	و سأل
وسؤال	و سؤال
وسئل	و سئل
وساحات	وساحات وساحات
وسارع	و سارع
وساعدت	و ساعدت
وسان	و سان
وسبب	و سبب
وسبق	و سبق
وسبقها	و سبق ها
وسبل	و سبل
وستبحث	و س تبحث
وستبذل	و س تبذل
وستة	و ستة
وستتأثر	و س تتأثر
وستتبع	و س تتبع
وستتركز	و س تتركز
وستتقدم	و س تتقدم
وستتم	و س تتم
وستتوصل	و س تتوصل
وستتولى	و س تتولى
وستجدون	و س تجدون
وستجري	و س تجري
وستحاول	و س تحاول
وستحكم	و س تحكم
وستدفع	و س تدفع
وستزداد	و س تزداد
وستسري	و س تسري
وستسعى	و س تسعى
وستشتري	و س تشتري
وستشمل	و س تشمل
وستشهد	و س تشهد
وستصدران	وستصدران وستصدران وستصدران
وستضم	و س تضم
وستظل	و س تظل
وستعقد	و س تعقد
وستعيد	و س تعيد
وستقوم	و س تقوم
وستكلفنا	و س تكلف نا
وستكون	و س تكون
وستمثل	و س تمثل
وستنتشر	و س تنتشر
وستوسع	و س توسع
وستُطرح	و س تطرح
وسجاد	و سجاد
وسجل	و سجل
وسجلت	و سجلت
وسحر	و سحر
وسرت	و سرت
وسرعان	و سرعان
وسرعة	و سرعة
وسرقة	و سرقة
وسرقت	و سرقت
وسريع	و سريع
وسريعة	و سريعة
وسطه	وسط ه
وسعاد	وسعاد وسعاد
وسعر	و سعر
وسعها	وسع ها
وسعيد	وسعيد وسعيد
وسفراء	و سفراء
وسفير	و سفير
وسقط	و سقط
وسقوط	و سقوط
وسلبي	و سلبي
وسلسلة	و سلسلة
وسلطة	و سلطة
وسلطت	و سلطت
وسلع	و سلع
وسلم	و سلم
وسلمته	و سلمت ه
وسمح	و سمح
وسمير	وسمير وسمير
وسنبقى	وسنبقى وسنبقى وسنبقى
وسنحتفل	وسنحتفل وسنحتفل وسنحتفل
وسندات	و سندات
وسنرفض	وسنرفض وسنرفض وسنرفض
وسنقاوم	وسنقاوم وسنقاوم وسنقاوم
وسهلاً	و سهلا
وسوء	و سوء
وسواء	و سواء
وسواها	و سوى ها
وسواهم	و سوى هم
وسواهما	وسواهما وسواهما وسواهما
وسواهن	و سوى هن
وسوريا	و سوريا
وسورية	و سورية
وسوسة	و سوسة
وسوف	و سوف
وسويسرا	و سويسرا
وسي	و سي
وسياتل	و سياتل
وسياحة	و سياحة
وسيادة	و سيادة
وسيادتنا	وسيادتنا وسيادتنا وسيادتنا
وسيادته	وسيادته وسيادته وسيادته
وسيارات	و سيارات
وسياسة	و سياسة
وسياسته	و سياسة ه
وسياسى	و سياسي
وسياسي	و سياسي
وسياسياً	و سياسيا
وسياسية	و سياسية
وسياسيين	و سياسيين
وسيبحث	و س يبحث
وسيبدأ	و س يبدأ
وسيبذل	و س يبذل
وسيبو	و سيبو
وسيتحقق	و س يتحقق
وسيتحمل	و س يتحمل
وسيتسلم	و س يتسلم
وسيتضمن	و س يتضمن
وسيتم	و س يتم
وسيتوجه	و س يتوجه
وسيتولى	و س يتولى
وسيجري	و س يجري
وسيجعل	و س يجعل
وسيحظى	و س يحظى
وسيحل	و س يحل
وسيختار	و س يختار
وسيخسر	و س يخسر
وسيخوض	و س يخوض
وسيدعم	و س يدعم
وسيذهب	و س يذهب
وسير	و سير
وسيرأس	و س يرأس
وسيرتفع	و س يرتفع
وسيزيد	و س يزيد
وسيسع	و س يسع
وسيطرة	وسيطرة وسيطرة
وسيطروا	و سيطروا
وسيظل	و س يظل
وسيعتبر	و س يعتبر
وسيعود	و س يعود
وسيغادران	و س يغادران
وسيغيب	و س يغيب
وسيقام	و س يقام
وسيقدم	و س يقدم
وسيقل	و س يقل
وسيقوم	و س يقوم
وسيكلف	و س يكلف
وسيكون	و س يكون
وسيلتحق	و س يلتحق
وسيلتقي	و س يلتقي
وسيلتقيه	و س يلتقي ه
وسينتخب	و س ينتخب
وسينفذ	و س ينفذ
وشؤونها	و شؤون ها
وشاءت	و شاءت
وشارك	و شارك
وشارون	و شارون
وشامل	و شامل
وشاملا	و شاملا
وشانغهاى	و شانغهاي
وشاهد	و شاهد
وشباب	و شباب
وشبه	و شبه
وشحذ	و شحذ
وشخصا	و شخصا
وشخصه	و شخص ه
وشخصيات	و شخصيات
وشد	و شد
وشدد	و شدد
وشددا	و شددا
وشددت	و شددت
وشدّد	و شدد
وشراء	و شراء
وشراسة	و شراسة
وشرب	و شرب
وشرعه	وشرعه وشرعه وشرعه
وشرق	و شرق
وشركات	و شركات
وشركة	و شركة
وشرم	وشرم وشرم
وشروط	و شروط
وشروطاً	و شروطا
وشطب	و شطب
وشعاب	و شعاب
وشعارات	وشعارات وشعارات
وشعب	و شعب
وشعر	و شعر
وشعوبها	وشعوبها وشعوبها وشعوبها
وشعور	و شعور
وشغل	و شغل
وشقة	وشقة وشقة
وشكاوى	و شكاوى
وشكاوي	و شكاوى
وشكر	و شكر
وشكرا	و شكرا
وشكرتهم	و شكرت هم
وشكل	و شكل
وشكلت	و شكلت
وشكوككم	و شكوك كم
وشكوكهم	و شكوك هم
وشكّلت	و شكلت
وشمال	و شمال
وشماله	و شمال ه
وشمل	و شمل
وشملت	و شملت
وشنت	و شنت
وشهاب	وشهاب وشهاب
وشهد	و شهد
وشهدت	و شهدت
وشهرة	وشهرة وشهرة
وشهود	و شهود
وشيخ	و شيخ
وشيوع	و شيوع
وصائب	وصائب وصائب
وصائغاً	و صائغا
وصاحب	و صاحب
وصادرات	و صادرات
وصادرت	و صادرت
وصار	و صار
وصاعدا	و صاعدا
وصالح	وصالح وصالح
وصحة	و صحة
وصحفيين	و صحفيين
وصحى	وصحى وصحى
وصدر	و صدر
وصرح	و صرح
وصرحت	و صرحت
وصرف	و صرف
وصريحة	وصريحة وصريحة
وصعد	و صعد
وصعدت	و صعدت
وصعود	و صعود
وصعودها	و صعود ها
وصفات	و صفات
وصفقات	و صفقات
وصفه	وصف ه
وصفها	وصف ها
وصفوني	وصفوني وصفوني
وصلاح	وصلاح وصلاح
وصلاحياتها	و صلاحيات ها
وصلتهم	وصلت هم
وصموئيل	و صموئيل
وصناديق	و صناديق
وصناعة	و صناعة
وصناعية	و صناعية
وصندوق	و صندوق
وصنعاء	و صنعاء
وصنعها	و صنع ها
وصوت	و صوت
وصور	و صور
وصورة	و صورة
وصوله	وصول ه
وصولها	وصول ها
وصولهم	وصول هم
وصياغتها	و صياغة ها
وصيانة	و صيانة
وصيانتها	و صيانة ها
وصيدا	وصيدا وصيدا
وصينية	و صينية
وضبط	و ضبط
وضخ	و ضخ
وضخه	و ضخ ه
وضد	و ضد
وضرائب	و ضرائب
وضرب	و ضرب
وضرورة	و ضرورة
وضروريا	و ضروريا
وضرورية	و ضرورية
وضريبة	و ضريبة
وضريبياً	و ضريبيا
وضعته	وضعت ه
وضعتها	وضعت ها
وضعف	و ضعف
وضعه	وضع ه
وضعها	وضع ها
وضغط	و ضغط
وضم	و ضم
وضمان	و ضمان
وضمانات	و ضمانات
وضمت	و ضمت
وضمتها	و ضمت ها
وضمن	و ضمن
وضمها	و ضم ها
وضياع	و ضياع
وطاجيكستان	وطاجيكستان وطاجيكستان
وطارق	وطارق وطارق
وطاقة	وطاقة وطاقة
وطاقته	و طاقة ه
وطالب	و طالب
وطالبة	و طالبة
وطالبت	و طالبت
وطالبن	و طالبن
وطالبها	و طالب ها
وطالبهم	و طالب هم
وطالبوا	و طالبوا
وطالما	و طالما
وطاول	و طاول
وطبقا	و طبقا
وطبيعة	و طبيعة
وطرأ	و طرأ
وطرابلس	و طرابلس
وطرح	و طرح
وطرحت	و طرحت
وطرق	و طرق
وطرقاً	و طرقا
وطريق	و طريق
وطغت	و طغت
وطغى	و طغى
وطفايات	و طفايات
وطفل	و طفل
وطلابية	و طلابية
وطلاسم	وطلاسم وطلاسم
وطلب	و طلب
وطلبات	و طلبات
وطلبت	و طلبت
وطلبوا	و طلبوا
وطمأن	و طمأن
وطمأنتهم	و طمأنة هم
وطمأنينة	و طمأنينة
وطنطاوي	وطنطاوي وطنطاوي
وطنه	وطنه وطنه
وطنيتهم	وطنية هم
وطهارته	و طهارة ه
وطهران	و طهران
وطوال	و طوال
وطوكيو	و طوكيو
وطول	و طول
وطوله	و طول ه
وطوم	و طوم
وطومسون	و طومسون
وطويلة	و طويلة
وطيب	وطيب وطيب
وطُرحت	و طرحت
وظل	و ظل
وظلم	وظلم وظلم
وظهر	و ظهر
وظهرت	و ظهرت
وظهور	و ظهور
وظيفتنا	وظيفتنا وظيفتنا
وظيفتهم	وظيفة هم
وعائد	و عائد
وعائلاتهم	و عائلات هم
وعائلته	و عائلة ه
وعاجلة	و عاجلة
وعاد	و عاد
وعادا	و عادا
وعادوا	و عادوا
وعاشها	و عاش ها
وعاصم	وعاصم وعاصم
وعاطف	وعاطف وعاطف
وعامر	وعامر وعامر
وعاملين	و عاملين
وعاود	و عاود
وعباس	وعباس وعباس
وعبد	و عبد
وعبدالمنعم	و عبدالمنعم
وعبر	و عبر
وعبوات	و عبوات
وعبيد	وعبيد وعبيد
وعثر	و عثر
وعجزوا	و عجزوا
وعجوز	و عجوز
وعدادات	و عدادات
وعدد	و عدد
وعددا	و عددا
وعدداً	و عددا
وعددها	و عدد ها
وعددهم	و عدد هم
وعدم	و عدم
وعدوانية	و عدوانية
وعراقية	و عراقية
وعراقيل	و عراقيل
وعراقيين	و عراقيين
وعرب	و عرب
وعربات	و عربات
وعربية	و عربية
وعرض	و عرض
وعرضا	و عرضا
وعرضت	و عرضت
وعرف	و عرف
وعرفات	وعرفات وعرفات
وعرفت	و عرفت
وعرقلة	و عرقلة
وعرقية	و عرقية
وعروض	و عروض
وعزا	و عزا
وعزل	و عزل
وعزوف	و عزوف
وعسكرية	و عسكرية
وعسل	و عسل
وعشرات	و عشرات
وعشرة	و عشرة
وعشرون	و عشرون
وعشرين	و عشرين
وعصائر	و عصائر
وعصام	وعصام وعصام
وعضو	و عضو
وعضواً	و عضوا
وعضوية	و عضوية
وعطاء	و عطاء
وعطاؤه	و عطاء ه
وعقب	و عقب
وعقد	و عقد
وعقدت	و عقدت
وعقـــد	و عقد
وعقيدته	و عقيدة ه
وعكته	وعكة ه
وعكست	و عكست
وعلاج	و علاج
وعلاجه	و علاج ه
وعلاقات	و علاقات
وعلاوات	و علاوات
وعلق	و علق
وعلل	و علل
وعلم	و علم
وعلماء	و علماء
وعلمت	و علمت
وعلمنا	وعلمنا وعلمنا
وعلميا	و علميا
وعلني	و علني
وعلومها	وعلومها وعلومها وعلومها
وعلى	و على
وعلي	وعلي وعلي
وعلينا	وعلينا وعلينا وعلينا
وعليه	و علي ه
وعليها	و علي ها
وعما	و عن ما
وعمارة	و عمارة
وعمان	و عمان
وعمقاً	و عمقا
وعمل	و عمل
وعملاء	و عملاء
وعملاً	و عملا
وعملت	و عملت
وعمليا	و عمليا
وعمليات	و عمليات
وعملياتها	و عمليات ها
وعملية	و عملية
وعميد	وعميد وعميد
وعن	و عن
وعناصر	و عناصر
وعناوين	وعناوين وعناوين
وعناوينها	و عناوين ها
وعند	و عند
وعندما	و عندما
وعنوانه	وعنوانه وعنوانه وعنوانه
وعهد	و عهد
وعوادمه	و عوادم ه
وعواصم	و عواصم
وعودة	و عودة
وعوقبت	و عوقبت
وعين	و عين
وعيناها	و عينا ها
وعيي	وعيي وعيي
وغادر	و غادر
وغادرها	و غادر ها
وغال	و غال
وغالبا	و غالبا
وغالبيتها	و غالبية ها
وغايته	و غاية ه
وغداة	و غداة
وغرامات	و غرامات
وغربها	و غرب ها
وغرفة	و غرفة
وغرق	و غرق
وغرقت	و غرقت
وغروب	و غروب
وغزة	و غزة
وغزو	و غزو
وغطاء	و غطاء
وغطى	و غطى
وغلاء	و غلاء
وغواصة	و غواصة
وغوش	و غوش
وغياب	و غياب
وغير	و غير
وغيره	و غير ه
وغيرها	و غير ها
وغيرهم	و غير هم
وغيرهما	و غير هما
وفؤاد	وفؤاد وفؤاد
وفائدة	و فائدة
وفاته	وفاة ه
وفاتها	وفاة ها
وفاز	و فاز
وفازت	و فازت
وفاعل	وفاعل وفاعل
وفاعلة	و فاعلة
وفاكس	وفاكس وفاكس
وفانوس	وفانوس وفانوس
وفتاة	و فتاة
وفتح	و فتح
وفترة	و فترة
وفتيات	و فتيات
وفجأة	و فجأة
وفجر	و فجر
وفحصها	و فحص ها
وفحصوا	و فحصوا
وفرص	و فرص
وفرض	و فرض
وفرضت	و فرضت
وفرضه	وفرضه وفرضه وفرضه
وفرق	و فرق
وفرنسا	و فرنسا
وفرنسيان	و فرنسيان
وفروا	و فروا
وفريدة	و فريدة
وفسر	و فسر
وفشل	و فشل
وفعل	و فعل
وفقدان	و فقدان
وفقداناً	و فقدانا
وفك	و فك
وفكريا	و فكريا
وفكرية	وفكرية وفكرية
وفلسطين	و فلسطين
وفلسطينيون	و فلسطينيون
وفلسطينيين	و فلسطينيين
وفلكية	و فلكية
وفلولهم	و فلول هم
وفن	وفن وفن
وفنانون	و فنانون
وفنلندا	و فنلندا
وفنلنديان	و فنلنديان
وفني	و فني
وفنية	و فنية
وفنيى	و فنيي
وفهم	و فهم
وفهماً	و فهما
وفوائد	و فوائد
وفوائده	و فوائد ه
وفوز	وفوز وفوز
وفوكس	و فوكس
وفى	و في
وفي	و في
وفيصل	وفيصل وفيصل
وفيلات	و فيلات
وفيلسوف	وفيلسوف وفيلسوف
وفيما	و فيما
وفينوس	وفينوس وفينوس
وفيه	و في ه
وفيها	و في ها
وقابلة	و قابلة
وقاد	و قاد
وقادة	و قادة
وقاده	و قاد ه
وقاسم	وقاسم وقاسم
وقاعدة	و قاعدة
وقال	و قال
وقالت	و قالت
وقالوا	و قالوا
وقام	و قام
وقامت	و قامت
وقاموا	و قاموا
وقانون	و قانون
وقبرص	و قبرص
وقبل	و قبل
وقبلوا	و قبلوا
وقبول	و قبول
وقتل	و قتل
وقتها	وقت ها
وقد	و قد
وقدر	و قدر
وقدرات	و قدرات
وقدرة	و قدرة
وقدم	و قدم
وقدمت	و قدمت
وقدموا	و قدموا
وقدوة	و قدوة
وقرأت	وقرأت وقرأت
وقراءته	و قراءة ه
وقراءتها	و قراءة ها
وقرارات	و قرارات
وقرر	و قرر
وقررت	و قررت
وقرع	وقرع وقرع
وقرغيزستان	و قرغيزستان
وقروض	و قروض
وقرية	و قرية
وقسم	و قسم
وقصرت	و قصرت
وقصي	و قصي
وقضايا	و قضايا
وقضت	و قضت
وقضى	و قضى
وقضية	و قضية
وقطاع	و قطاع
وقطر	و قطر
وقطع	و قطع
وقطعت	و قطعت
وقطعوا	و قطعوا
وقعته	وقعت ه
وقعتها	وقعت ها
وقعه	وقع ه
وقعها	وقع ها
وقفز	و قفز
وقفزت	و قفزت
وقفها	وقف ها
وقلب	و قلب
وقلة	و قلة
وقلعة	وقلعة وقلعة
وقلقه	و قلق ه
وقلل	و قلل
وقم	و قم
وقنوات	و قنوات
وقوات	و قوات
وقوانين	و قوانين
وقوة	و قوة
وقوعه	وقوع ه
وقوعها	وقوع ها
وقومي	و قومي
وقومية	وقومية وقومية
وقوية	و قوية
وقيادات	و قيادات
وقياداته	و قيادات ه
وقيادة	و قيادة
وقيادتها	و قيادة ها
وقياس	و قياس
وقيام	و قيام
وقيامه	و قيام ه
وقيامها	و قيام ها
وقيل	و قيل
وقيم	و قيم
وقيماً	و قيما
وقيمة	و قيمة
وقيمتها	و قيمة ها
وقيّم	و قيم
وكأسين	و كأسين
وكأن	و ك أن
وكأننا	وكأننا وكأننا وكأننا وكأننا
وكأنه	و ك أن ه
وكازاخستان	وكازاخستان وكازاخستان
وكافة	و كافة
وكان	و كان
وكانت	و كانت
وكانتا	و كانتا
وكانوا	و كانوا
وكبار	و كبار
وكبير	و كبير
وكبيرة	و كبيرة
وكتائب	و كتائب
وكتب	و كتب
وكثيراً	و كثيرا
وكذا	و كذا
وكذلك	و كذٰلك
وكرامة	و كرامة
وكرة	و كرة
وكرد	و ك رد
وكرر	و كرر
وكرواتيا	و كرواتيا
وكسب	و كسب
وكشف	و كشف
وكشفت	و كشفت
وكشمير	و كشمير
وكفاءة	و كفاءة
وكل	و كل
وكلاهما	و كلا هما
وكلف	و كلف
وكلفته	و كلفت ه
وكلما	و كلما
وكلها	و كل ها
وكلياتها	وكلياتها وكلياتها وكلياتها
وكلية	وكلية وكلية
وكم	و كم
وكما	و كما
وكميات	و كميات
وكنا	و كنا
وكنت	وكنت وكنت
وكهوف	وكهوف وكهوف
وكوبا	و كوبا
وكوريا	و كوريا
وكولومبيا	و كولومبيا
وكوندوليزا	و كوندوليزا
وكيانها	و كيان ها
وكيف	و كيف
وكين	و كين
وكينيا	و كينيا
ولآجال	ولآجال ولآجال ولآجال
ولأبناء	و ل أبناء
ولأن	و لأن
ولأول	و ل أول
ولا	و لا
ولائحة	و لائحة
ولابد	و لا بد
ولاجراء	و ل إجراء
ولاحظ	و لاحظ
ولاحظت	و لاحظت
ولاذت	و لاذت
ولاسباب	و ل أسباب
ولاسيما	ولاسيما ولاسيما
ولاعب	و لاعب
ولان	و لأن
ولايته	ولاية ه
ولايتها	ولاية ها
ولايمانكم	و ل إيمان كم
ولبعض	و ل بعض
ولبنان	و لبنان
ولبنانية	و لبنانية
ولتأكيد	ولتأكيد ولتأكيد ولتأكيد
ولتبرير	و ل تبرير
ولتحسين	و ل تحسين
ولتحقيق	و ل تحقيق
ولتسهيل	و ل تسهيل
ولتنمية	و ل تنمية
ولجان	و لجان
ولجانه	و لجان ه
ولحق	و لحق
ولحم	و لحم
ولحية	و لحية
ولخص	و لخص
ولخصوصية	ولخصوصية ولخصوصية ولخصوصية
ولدائن	و لدائن
ولدرس	و ل درس
ولدوره	و ل دور ه
ولدى	و لدى
ولديه	و لدي ه
ولديها	و لدي ها
ولذا	و لذا
ولذلك	و لذٰلك
ولرفع	و ل رفع
ولسنا	و لسنا
ولضعف	و ل ضعف
ولعب	و لعب
ولعدم	و ل عدم
ولعل	و ل عل
ولــكنها	و لٰكن ها
ولفت	و لفت
ولفتت	و لفتت
ولقاء	و لقاء
ولقاءه	و لقاء ه
ولقائه	و لقاء ه
ولقنوات	و ل قنوات
ولقي	و لقي
ولكن	و لٰكن
ولكننا	ولكننا ولكننا ولكننا
ولكنه	و لٰكن ه
ولكنها	و لٰكن ها
ولكنهم	و لٰكن هم
ولكي	و لكي
وللأسرة	و ل الأسرة
وللارتباط	و ل الارتباط
وللاسطول	و ل الأسطول
وللاعتداء	و ل الاعتداء
وللانتفاضة	و ل الانتفاضة
وللتبادل	و ل التبادل
وللترابط	و ل الترابط
وللتنديد	و ل التنديد
وللدخول	و ل الدخول
وللظروف	و ل الظروف
وللفترة	و ل الفترة
وللمرة	و ل المرة
وللمسافرين	و ل المسافرين
وللمسلمين	و ل المسلمين
وللمواطنين	و ل المواطنين
وللنفق	و ل النفق
وللوسطاء	و ل الوسطاء
ولم	و لم
ولما	و ل ما
ولمح	و لمح
ولمدة	و ل مدة
ولمرشحي	و ل مرشحي
ولمزيد	و ل مزيد
ولمشاريع	و ل مشاريع
ولمناسبة	ولمناسبة ولمناسبة ولمناسبة
ولن	و لن
ولنا	ولنا ولنا ولنا
ولندن	و لندن
ولنفكر	ولنفكر ولنفكر ولنفكر
وله	و ل ه
ولها	و ل ها
ولهذا	و ل هٰذا
ولهم	و ل هم
ولو	و لو
ولوجود	و ل وجود
ولوس	و لوس
ولوقف	و ل وقف
ولولا	و لولا
وليبرالية	و ليبرالية
وليبيا	و ليبيا
وليس	و ليس
وليست	و ليست
وليـــس	و ليس
وليــــس	و ليس
ومآس	و مآس
ومؤازرته	و مؤازرة ه
ومؤثرة	و مؤثرة
ومؤسسات	و مؤسسات
ومؤسسة	و مؤسسة
ومؤسسها	و مؤسس ها
ومؤســسات	و مؤسسات
ومؤشرات	و مؤشرات
ومؤلفون	و مؤلفون
ومؤلمة	و مؤلمة
ومؤمنة	و مؤمنة
ومؤهلا	و مؤهلا
ومئات	و مئات
ومئتي	و مئتي
وما	و ما
وماثلة	و ماثلة
وماجد	وماجد وماجد
وماذا	و ماذا
وماراثون	و ماراثون
وماركات	و ماركات
ومازال	و ما زال
ومازالت	و ما زالت
ومازالوا	و ما زالوا
وماضيه	و ماضي ه
ومافوق	و ما فوق
وماكينات	و ماكينات
ومالاوي	و مالاوي
ومالت	و مالت
وماليا	و ماليا
ومالياً	و ماليا
وماهو	وماهو وماهو
ومبادئ	و مبادئ
ومبادىء	و مبادئ
ومباشرة	و مباشرة
ومبدأ	و مبدإ
ومبروك	ومبروك ومبروك
ومتأن	و متأن
ومتابعة	و متابعة
ومتابعتها	و متابعة ها
ومتانة	و متانة
ومترجم	و مترجم
ومتطلبات	و متطلبات
ومتطور	ومتطور ومتطور
ومتظاهرين	و متظاهرين
ومتعطلة	و متعطلة
ومتقدمة	و متقدمة
ومتمردى	و متمردي
ومتهماً	و متهما
ومتوازنا	و متوازنا
ومتوازنة	و متوازنة
ومتوجها	و متوجها
ومتوجهة	و متوجهة
ومتوسطي	و متوسطي
ومتوقعة	و متوقعة
ومتى	و متى
ومثال	ومثال ومثال
ومثل	و مثل
ومثلت	و مثلت
ومجازر	و مجازر
ومجالات	و مجالات
ومجالس	و مجالس
ومجتمع	و مجتمع
ومجتمعاتهم	و مجتمعات هم
ومجلات	و مجلات
ومجلس	و مجلس
ومجمع	و مجمع
ومجموع	و مجموع
ومجموعة	و مجموعة
ومحادثات	و محادثات
ومحادثاته	و محادثات ه
ومحاربة	و محاربة
ومحاسيبها	و محاسيب ها
ومحاصرتها	و محاصرة ها
ومحافظ	و محافظ
ومحامون	و محامون
ومحامين	و محامين
ومحاولات	و محاولات
ومحاولة	و محاولة
ومحبة	ومحبة ومحبة
ومحددة	و محددة
ومحدودية	و محدودية
ومحطات	و محطات
ومحطة	و محطة
ومحلات	و محلات
ومحللون	و محللون
ومحلية	و محلية
ومحمد	ومحمد ومحمد
ومحمود	ومحمود ومحمود
ومحورية	و محورية
ومحيطها	و محيط ها
ومحيي	ومحيي ومحيي
ومخالف	و مخالف
ومختلف	و مختلف
ومختلفين	و مختلفين
ومخصصاتهم	و مخصصات هم
ومخطوطات	و مخطوطات
ومخطوطتين	و مخطوطتين
ومخيم	و مخيم
ومد	و مد
ومدته	و مدة ه
ومدرب	و مدرب
ومدربه	و مدرب ه
ومدرس	و مدرس
ومدروسة	و مدروسة
ومدن	و مدن
ومدنية	و مدنية
ومدى	و مدى
ومدير	و مدير
ومدينة	و مدينة
ومذاهبهم	و مذاهب هم
ومذكراً	و مذكرا
ومذهبية	و مذهبية
ومراجعة	و مراجعة
ومراعاة	و مراعاة
ومرافقيهم	و مرافقي هم
ومراكز	و مراكز
ومرة	و مرة
ومرتفعات	و مرتفعات
ومرحلة	و مرحلة
ومرزوق	ومرزوق ومرزوق
ومرشد	و مرشد
ومرض	و مرض
ومرفأ	و مرفأ
ومركز	و مركز
ومركزا	و مركزا
ومركزات	و مركزات
ومركزاً	و مركزا
ومزاجه	و مزاج ه
ومزاحمة	ومزاحمة ومزاحمة
ومزاولة	و مزاولة
ومزاياه	و مزايا ه
ومزيد	و مزيد
ومسألة	و مسألة
ومسؤولو	و مسؤولو
ومسؤولي	و مسؤولي
ومسؤوليات	و مسؤوليات
ومسئوليات	و مسؤوليات
ومسئولين	و مسؤولين
ومسائل	و مسائل
ومساحة	و مساحة
ومسار	و مسار
ومسارعة	و مسارعة
ومساعد	و مساعد
ومساعدة	و مساعدة
ومساعدتهم	و مساعدة هم
ومساعده	و مساعد ه
ومساعدوهم	و مساعدو هم
ومساند	و مساند
ومساهمة	و مساهمة
ومساواة	و مساواة
ومسبباته	و مسببات ه
ومستثمرين	و مستثمرين
ومستجيبا	و مستجيبا
ومستحضرات	و مستحضرات
ومستشارة	ومستشارة ومستشارة
ومستشفى	و مستشفى
ومستقبل	و مستقبل
ومستقل	و مستقل
ومستلزمات	و مستلزمات
ومستمعاً	و مستمعا
ومسعود	ومسعود ومسعود
ومسلحين	و مسلحين
ومسلم	و مسلم
ومسلميه	و مسلمي ه
ومسمع	و مسمع
ومسيحيين	و مسيحيين
ومشاركة	و مشاركة
ومشاريع	و مشاريع
ومشاغل	و مشاغل
ومشاكل	و مشاكل
ومشاكلكم	و مشاكل كم
ومشاورات	و مشاورات
ومشتركة	و مشتركة
ومشدداً	و مشددا
ومشربة	ومشربة ومشربة
ومشروع	و مشروع
ومشروعات	و مشروعات
ومشروعان	و مشروعان
ومشكلة	ومشكلة ومشكلة
ومصابيح	و مصابيح
ومصابين	و مصابين
ومصادر	و مصادر
ومصادرة	و مصادرة
ومصاريف	و مصاريف
ومصالح	و مصالح
ومصالحهـــا	ومصالحهـــا ومصالحهـــا ومصالحهـــا
ومصانعهم	و مصانع هم
ومصحفا	و مصحفا
ومصدر	و مصدر
ومصر	و مصر
ومصرية	و مصرية
ومصريون	و مصريون
ومصعوقة	ومصعوقة ومصعوقة
ومصلحة	و مصلحة
ومصنعاً	و مصنعا
ومصير	و مصير
ومضاعفاتها	و مضاعفات ها
ومضخات	و مضخات
ومضطر	ومضطر ومضطر
ومضى	و مضى
ومطالبة	و مطالبة
ومظاهرات	و مظاهرات
ومع	و مع
ومعاداة	و معاداة
ومعارضة	و معارضة
ومعارفه	و معارف ه
ومعالجة	و معالجة
ومعالي	ومعالي ومعالي
ومعاهدها	ومعاهدها ومعاهدها ومعاهدها
ومعاونة	و معاونة
ومعايرة	و معايرة
ومعايير	و معايير
ومعتبراً	و معتبرا
ومعدات	و معدات
ومعدل	و معدل
ومعرفة	و معرفة
ومعروف	و معروف
ومعسكر	و معسكر
ومعظم	ومعظم ومعظم
ومعلموهم	و معلمو هم
ومعلوم	و معلوم
ومعلومات	و معلومات
ومعه	و مع ه
ومعها	و مع ها
ومعوقات	و معوقات
ومغاربها	و مغارب ها
ومــزورة	و مزورة
ومفكرين	و مفكرين
ومفيدة	و مفيدة
ومقابل	و مقابل
ومقاتلي	و مقاتلي
ومقاربة	و مقاربة
ومقاطعة	و مقاطعة
ومقاولون	و مقاولون
ومقاومة	و مقاومة
ومقترحات	و مقترحات
ومقتل	ومقتل ومقتل
ومقدارها	و مقدار ها
ومقدساتها	و مقدسات ها
ومقدوني	و مقدوني
ومقره	و مقر ه
ومقرها	ومقرها ومقرها ومقرها
ومقلة	و مقلة
ومقوماتها	و مقومات ها
ومكاتب	و مكاتب
ومكافحة	و مكافحة
ومكانة	و مكانة
ومكتب	و مكتب
ومكوناتها	و مكونات ها
وملابس	و ملابس
وملاحة	و ملاحة
وملاحقة	و ملاحقة
وملح	وملح وملح
وملحوظاً	و ملحوظا
وملف	و ملف
وملككم	وملككم وملككم وملككم
ومليار	و مليار
ومما	و مما
وممارسات	و ممارسات
وممارسة	و ممارسة
وممارستها	و ممارسة ها
وممثل	و ممثل
وممثلة	وممثلة وممثلة
وممثلي	و ممثلي
وممنوعٌ	و ممنوع
ومميزاته	و مميزات ه
ومن	و من
ومنازل	و منازل
ومناطق	و مناطق
ومنافعه	ومنافعه ومنافعه ومنافعه
ومناقشة	و مناقشة
ومنتج	و منتج
ومنتجات	و منتجات
ومنتجاته	و منتجات ه
ومنتجي	و منتجي
ومنجمية	و منجمية
ومنح	و منح
ومنحت	و منحت
ومندوب	و مندوب
ومندوبي	و مندوبي
ومنذ	و منذ
ومنسجمة	و منسجمة
ومنسقة	ومنسقة ومنسقة
ومنسوبيها	و منسوبي ها
ومنصات	و منصات
ومنطق	ومنطق ومنطق
ومنطقة	و منطقة
ومنظمات	و منظمات
ومنظماته	ومنظماته ومنظماته ومنظماته
ومنظمة	و منظمة
ومنظومات	و منظومات
ومنع	و منع
ومنعه	ومنعه ومنعه ومنعه
ومنعها	و منع ها
ومنغوليا	و منغوليا
ومنها	و من ها
ومنهم	و من هم
ومنى	ومنى ومنى
ومهتمين	و مهتمين
ومهما	و مهما
ومهمة	و مهمة
ومهمتي	ومهمتي ومهمتي ومهمتي
ومهني	و مهني
وموائد	و موائد
ومواجهة	و مواجهة
ومواد	و مواد
وموارد	و موارد
وموارده	و موارد ه
وموازاة	و موازاة
ومواسم	و مواسم
ومواصفات	و مواصفات
ومواصلات	و مواصلات
ومواصلة	و مواصلة
ومواضيع	و مواضيع
ومواطني	و مواطني
ومواطنيه	و مواطني ه
ومواعيد	و مواعيد
وموافقتها	وموافقتها وموافقتها وموافقتها
ومواقد	ومواقد ومواقد
ومواقع	و مواقع
ومواقف	و مواقف
وموانئ	و موانئ
ومودة	ومودة ومودة
وموريتانيا	و موريتانيا
وموزعون	و موزعون
وموزمبيق	و موزمبيق
وموسعاً	و موسعا
وموسعة	و موسعة
وموسيقى	وموسيقى وموسيقى
وموضة	و موضة
وموضوع	و موضوع
وموضوعية	و موضوعية
وموظفيها	و موظفي ها
وموفاز	و موفاز
وموقف	و موقف
ومولانا	ومولانا ومولانا ومولانا
ومي	و مي
وميانمار	وميانمار وميانمار
ومياه	و مياه
ومياههما	و مياه هما
وميثاقها	و ميثاق ها
وميداني	و ميداني
وميزان	و ميزان
وميسرة	و ميسرة
وميغان	و ميغان
وميكنة	و ميكنة
ونأمل	ونأمل ونأمل
ونائب	و نائب
ونائبة	ونائبة ونائبة
ونائبه	و نائب ه
وناجح	و ناجح
وناخيتشيفان	و ناخيتشيفان
ونادي	ونادي ونادي
وناشد	و ناشد
وناشدهم	و ناشد هم
ونافذة	ونافذة ونافذة
وناقشنا	وناقشنا وناقشنا
وناقشوا	و ناقشوا
ونال	و نال
وناميبيا	و ناميبيا
ونبه	و نبه
ونتائج	و نتائج
ونتائجه	و نتائج ه
ونتائجها	ونتائجها ونتائجها ونتائجها
ونتج	و نتج
ونتجت	و نتجت
ونتمنى	و نتمنى
ونتيجة	و نتيجة
ونجاح	و نجاح
ونجحت	و نجحت
ونجله	و نجل ه
ونجومها	و نجوم ها
ونحاول	ونحاول ونحاول
ونحب	ونحب ونحب
ونحـــن	ونحـــن ونحـــن
ونحن	و نحن
ونحو	و نحو
وندد	و ندد
ونرحب	ونرحب ونرحب
ونرى	ونرى ونرى
ونزاهته	و نزاهة ه
ونزع	ونزع ونزع
ونزعته	ونزعته ونزعته ونزعته
ونزوله	و نزول ه
ونساء	و نساء
ونسبة	و نسبة
ونسبت	و نسبت
ونسبته	و نسبة ه
ونشأت	و نشأت
ونشاط	و نشاط
ونشاطاتهم	و نشاطات هم
ونشر	و نشر
ونشرت	و نشرت
ونشره	و نشر ه
ونصح	و نصح
ونصحت	و نصحت
ونصف	و نصف
ونصفهم	و نصف هم
ونصوص	ونصوص ونصوص
ونصوصا	و نصوصا
ونظافة	و نظافة
ونظام	و نظام
ونظاما	و نظاما
ونظامه	و نظام ه
ونظرا	و نظرا
ونظرائهم	و نظراء هم
ونظرات	و نظرات
ونظراً	و نظرا
ونظرتها	و نظرة ها
ونظم	و نظم
ونظيره	و نظير ه
ونظيرها	و نظير ها
ونظيفة	و نظيفة
ونعيش	ونعيش ونعيش
ونفت	و نفت
ونفذ	و نفذ
ونفسيا	و نفسيا
ونفى	و نفى
ونفي	ونفي ونفي
ونقابة	ونقابة ونقابة
ونقاط	و نقاط
ونقدا	و نقدا
ونقص	و نقص
ونقصاً	و نقصا
ونقل	و نقل
ونقلت	و نقلت
ونقلته	و نقلت ه
ونقله	و نقل ه
ونقلوه	و نقلوا ه
ونقمته	و نقمة ه
ونقيب	و نقيب
ونقيضه	ونقيضه ونقيضه ونقيضه
ونكهة	و نكهة
ونمو	و نمو
وننجح	وننجح وننجح
وننجرف	وننجرف وننجرف
ونهج	و نهج
ونواب	و نواب
ونواة	و نواة
ونور	ونور ونور
ونورد	ونورد ونورد
ونوع	و نوع
ونوعاً	و نوعا
ونوعية	و نوعية
ونوه	و نوه
ونياتها	و نيات ها
ونيال	ونيال ونيال
ونيجيريا	و نيجيريا
ونيوزيلندا	و نيوزيلندا
ونيويورك	و نيويورك
وها	و ها
وهاجم	و هاجم
وهاجمت	و هاجمت
وهاجموا	و هاجموا
وهامة	و هامة
وهبطت	و هبطت
وهبوط	و هبوط
وهبوطها	و هبوط ها
وهتافات	و هتافات
وهجرة	وهجرة وهجرة
وهدد	و هدد
وهددت	و هددت
وهدفها	و هدف ها
وهدم	و هدم
وهدوء	و هدوء
وهذا	و هٰذا
وهذان	و هٰذان
وهذه	و هٰذه
وهرب	و هرب
وهربوا	و هربوا
وهل	و هل
وهم	و هم
وهما	و هما
وهمومها	وهمومها وهمومها وهمومها
وهن	و هن
وهنا	و هنا
وهناك	و هناك
وهو	و هو
وهواتف	و هواتف
وهولندا	وهولندا وهولندا
وهوياتهم	و هويات هم
وهوية	وهوية وهوية
وهى	و هي
وهي	و هي
وهيئة	و هيئة
وهياكل	و هياكل
وهيكلة	و هيكلة
وهيمنة	و هيمنة
وواجب	و واجب
وواجباتنا	وواجباتنا وواجباتنا وواجباتنا
وواجبها	و واجب ها
وواجه	و واجه
وواجهت	و واجهت
وواحد	و واحد
ووادي	و وادي
وواردات	و واردات
وواردة	و واردة
وواشنطن	و واشنطن
وواضحة	و واضحة
وواعدة	و واعدة
ووافق	و وافق
ووافقت	و وافقت
وواقع	و واقع
ووالدة	و والدة
ووالدي	ووالدي ووالدي ووالدي
ووثائق	و وثائق
ووجه	و وجه
ووجهت	و وجهت
ووجهتها	ووجهتها ووجهتها ووجهتها
ووجود	و وجود
ووجودها	و وجود ها
ووجودهم	و وجود هم
ووجوه	و وجوه
ووحدات	و وحدات
ووحدة	و وحدة
وود	و ود
وودائع	و ودائع
وورثه	و ورث ه
وورش	و ورش
ووزارة	و وزارة
ووزراء	و وزراء
ووزع	و وزع
ووزعت	و وزعت
ووزير	و وزير
ووزيرة	و وزيرة
ووزيري	و وزيري
ووسائل	و وسائل
ووسامين	و وسامين
ووسيلة	و وسيلة
ووصف	و وصف
ووصفت	و وصفت
ووصفتها	و وصفت ها
ووصفه	و وصف ه
ووصفها	و وصف ها
ووصل	و وصل
ووصلت	و وصلت
ووصول	و وصول
ووضع	و وضع
ووضعت	و وضعت
ووضعها	و وضع ها
ووعد	و وعد
ووفد	و وفد
ووفقا	و وفقا
ووفقاً	و وفقا
ووفود	و وفود
ووفوداً	و وفودا
ووفيات	و وفيات
ووقع	و وقع
ووقعت	و وقعت
ووقعتا	و وقعتا
ووقف	و وقف
ووقفة	ووقفة ووقفة
ووقود	و وقود
ووكالة	و وكالة
ووكلاء	و وكلاء
ووكيل	و وكيل
وولاء	وولاء وولاء
وولايات	وولايات وولايات
وولاية	و ولاية
ووليام	ووليام ووليام
ووليد	ووليد ووليد
ووهب	و وهب
ووهبة	ووهبة ووهبة
ويأتى	و يأتي
ويأتي	و يأتي
ويأمل	و يأمل
ويأملون	و يأملون
ويؤثر	و يؤثر
ويؤكد	و يؤكد
ويؤمن	و يؤمن
وياتي	و يأتي
وياسر	وياسر وياسر
وياسف	و يأسف
ويافا	و يافا
ويبتعد	و يبتعد
ويبحث	و يبحث
ويبدأ	و يبدأ
ويبدو	و يبدو
ويبذل	و يبذل
ويبرز	و يبرز
ويبعث	و يبعث
ويبقى	و يبقى
ويبلغ	و يبلغ
ويبيعه	و يبيع ه
ويتأتى	و يتأتى
ويتأهل	و يتأهل
ويتبنونه	و يتبنون ه
ويتبنى	و يتبنى
ويتحدث	و يتحدث
ويتحسب	و يتحسب
ويتحسن	و يتحسن
ويتحكم	و يتحكم
ويتحمس	و يتحمس
ويتحمل	و يتحمل
ويتحملون	و يتحملون
ويتخذا	و يتخذا
ويتخوف	و يتخوف
ويتراوح	و يتراوح
ويترددن	و يترددن
ويترقبن	ويترقبن ويترقبن
ويتركز	و يتركز
ويتصل	و يتصل
ويتضخم	و يتضخم
ويتضمن	و يتضمن
ويتعامل	و يتعامل
ويتعاون	و يتعاون
ويتفق	و يتفق
ويتقاضى	و يتقاضى
ويتكون	و يتكون
ويتلقى	ويتلقى ويتلقى
ويتم	و يتم
ويتمتع	و يتمتع
ويتمثل	و يتمثل
ويتنافس	و يتنافس
ويتنافسون	و يتنافسون
ويتنقل	و يتنقل
ويتوقع	و يتوقع
ويتولى	ويتولى ويتولى
ويتيح	و يتيح
ويجب	و يجب
ويجبر	و يجبر
ويجبرون	و يجبرون
ويجتهد	و يجتهد
ويجرى	و يجري
ويجري	و يجري
ويجيز	و يجيز
ويحاولون	و يحاولون
ويحتاج	و يحتاج
ويحتل	و يحتل
ويحتوي	و يحتوي
ويحدث	و يحدث
ويحدد	و يحدد
ويحذر	و يحذر
ويحرر	و يحرر
ويحرمها	و يحرم ها
ويحض	و يحض
ويحظر	و يحظر
ويحظى	و يحظى
ويحفزنا	ويحفزنا ويحفزنا ويحفزنا
ويحقق	و يحقق
ويحمل	و يحمل
ويحميه	و يحمي ه
ويحمّل	و يحمل
ويحوّل	و يحول
ويختتم	و يختتم
ويخدع	و يخدع
ويخدم	و يخدم
ويخرج	و يخرج
ويخرجها	و يخرج ها
ويخضع	و يخضع
ويخلي	و يخلي
ويدافع	و يدافع
ويدافعوا	و يدافعوا
ويدرسون	و يدرسون
ويدرك	و يدرك
ويدعموا	و يدعموا
ويدعو	و يدعو
ويدعوان	و يدعوان
ويدور	و يدور
ويذكر	و يذكر
ويراجعوا	ويراجعوا ويراجعوا
ويربط	و يربط
ويرتفع	و يرتفع
ويرجع	و يرجع
ويرسم	و يرسم
ويرفض	و يرفض
ويرفضون	و يرفضون
ويرفع	و يرفع
ويرى	و يرى
ويريد	و يريد
ويزور	و يزور
ويزيد	و يزيد
ويزيدهم	و يزيد هم
ويساعد	و يساعد
ويساهم	و يساهم
ويستشهد	و يستشهد
ويستطرد	و يستطرد
ويستطيع	و يستطيع
ويستعدون	و يستعدون
ويستعرض	و يستعرض
ويستغرق	و يستغرق
ويستقر	و يستقر
ويستمر	و يستمر
ويستمع	و يستمع
ويستهدف	و يستهدف
ويستيقظ	و يستيقظ
ويسعى	و يسعى
ويسمح	و يسمح
ويسود	و يسود
ويسير	و يسير
ويشار	و يشار
ويشارك	و يشارك
ويشبه	و يشبه
ويشتبه	و يشتبه
ويشترك	و يشترك
ويشتكي	و يشتكي
ويشجع	و يشجع
ويشعلون	و يشعلون
ويشغل	و يشغل
ويشكل	و يشكل
ويشكو	و يشكو
ويشمل	و يشمل
ويشير	و يشير
ويشيرون	و يشيرون
ويصدر	و يصدر
ويصعب	و يصعب
ويصعد	و يصعد
ويصل	و يصل
ويضاعف	و يضاعف
ويضاف	و يضاف
ويضر	و يضر
ويضرب	و يضرب
ويضعنا	ويضعنا ويضعنا ويضعنا
ويضعوا	ويضعوا ويضعوا
ويضغط	و يضغط
ويضم	و يضم
ويضمن	و يضمن
ويضيف	و يضيف
ويطالبان	و يطالبان
ويطبق	و يطبق
ويطرحها	و يطرح ها
ويطلب	و يطلب
ويطلقون	و يطلقون
ويطوق	و يطوق
ويظل	و يظل
ويعاد	و يعاد
ويعانون	و يعانون
ويعتبر	و يعتبر
ويعتبرون	و يعتبرون
ويعتزم	و يعتزم
ويعتقد	و يعتقد
ويعتمد	و يعتمد
ويعد	و يعد
ويعرض	و يعرض
ويعرف	و يعرف
ويعزز	و يعزز
ويعطى	ويعطى ويعطى
ويعكس	و يعكس
ويعلم	و يعلم
ويعلن	و يعلن
ويعمل	و يعمل
ويعني	و يعني
ويعيش	و يعيش
ويعيشون	و يعيشون
ويغادر	و يغادر
ويغطي	و يغطي
ويغيب	و يغيب
ويغير	و يغير
ويفترض	و يفترض
ويفتقر	و يفتقر
ويفكر	و يفكر
ويفيد	ويفيد ويفيد
ويقام	و يقام
ويقاوم	و يقاوم
ويقتصر	و يقتصر
ويقدر	و يقدر
ويقدس	و يقدس
ويقدم	و يقدم
ويقرر	و يقرر
ويقضي	و يقضي
ويقضيها	و يقضي ها
ويقع	و يقع
ويقف	و يقف
ويقلل	و يقلل
ويقودها	و يقود ها
ويقول	و يقول
ويقوم	و يقوم
ويقيم	و يقيم
ويقيمون	و يقيمون
ويقيني	ويقيني ويقيني ويقيني
ويكافحون	و يكافحون
ويكفوا	ويكفوا ويكفوا
ويكفي	و يكفي
ويكمن	و يكمن
ويكون	و يكون
ويلاحق	و يلاحق
ويلبي	و يلبي
ويلجأ	و يلجأ
ويلزم	و يلزم
ويلعب	و يلعب
ويلفت	و يلفت
ويلقى	و يلقى
ويلم	ويلم ويلم
ويليه	و يلي ه
ويمتد	و يمتد
ويمتلك	و يمتلك
ويمثل	و يمثل
ويمكن	و يمكن
ويمكننا	ويمكننا ويمكننا ويمكننا
ويمكنني	ويمكنني ويمكنني ويمكنني
ويمكنها	و يمكن ها
ويملك	و يملك
ويمنع	و يمنع
ويمهد	و يمهد
ويناقش	و يناقش
وينتج	و ينتج
وينتظر	و ينتظر
وينتقص	و ينتقص
وينتمي	و ينتمي
وينتهي	و ينتهي
وينسجم	و ينسجم
وينص	و ينص
وينصب	و ينصب
وينظر	و ينظر
وينعكس	و ينعكس
وينفذ	و ينفذ
وينفذها	و ينفذ ها
وينقسم	و ينقسم
وينهي	و ينهي
ويهاجم	و يهاجم
ويهدف	و يهدف
ويوجد	و يوجد
ويوجه	و يوجه
ويوسف	ويوسف ويوسف
ويوضحا	ويوضحا ويوضحا
ويوغوسلافيا	و يوغوسلافيا
ويوفر	و يوفر
ويومبلغاز	ويومبلغاز ويومبلغاز
ويوناني	و يوناني
ويُتوقع	و يتوقع
ويُضاعف	و يضاعف
ويُعتقد	و يعتقد
يأخذه	يأخذ ه
يؤذيه	يؤذي ه
يبحثها	يبحث ها
يبررها	يبرر ها
يبكيها	يبكي ها
يتبناها	يتبنى ها
يتحملها	يتحمل ها
يتزعمه	يتزعم ه
يتزعمها	يتزعم ها
يتصوره	يتصور ه
يتصورها	يتصور ها
يتطلبه	يتطلب ه
يتطلبها	يتطلب ها
يتقدمهم	يتقدم هم
يتلقاها	يتلقى ها
يتلوها	يتلو ها
يتولاه	يتولى ه
يثيرها	يثير ها
يجده	يجد ه
يجريه	يجري ه
يجريها	يجري ها
يجعلنا	يجعلنا يجعلنا
يجعلها	يجعل ها
يجمعنا	يجمعنا يجمعنا
يحبني	يحبني يحبني
يحتاجها	يحتاج ها
يحتاجونه	يحتاجون ه
يحتجزهم	يحتجز هم
يحتجزونهم	يحتجزون هم
يحتلها	يحتل ها
يحدده	يحدد ه
يحددها	يحدد ها
يحدوهم	يحدو هم
يحسها	يحس ها
يحضره	يحضر ه
يحفزنا	يحفزنا يحفزنا
يحفظه	يحفظ ه
يحققها	يحقق ها
يحمله	يحمل ه
يحملها	يحمل ها
يختاره	يختار ه
يختارها	يختارها يختارها
يخرجه	يخرج ه
يداها	يدا ها
يدخله	يدخل ه
يدخلها	يدخل ها
يدرسه	يدرس ه
يدرسها	يدرس ها
يدركه	يدرك ه
يدعوهم	يدعو هم
يدفعني	يدفعني يدفعني
يدفعه	يدفع ه
يده	يد ه
يديرها	يدير ها
يديرونها	يديرون ها
يديه	يدي ه
يرأسها	يرأس ها
يرئسه	يرئس ه
يرافقه	يرافق ه
يراه	يرى ه
يربطها	يربط ها
يرتكبه	يرتكب ه
يرتكبها	يرتكب ها
يردده	يردد ه
يرفعها	يرفع ها
يريده	يريده يريده
يريدها	يريد ها
يزرعها	يزرع ها
يزورها	يزور ها
يزوروني	يزوروني يزوروني
يزيله	يزيل ه
يسألني	يسألني يسألني
يساعدني	يساعدني يساعدني
يساعدهم	يساعد هم
يساندهم	يساند هم
يسببه	يسبب ه
يستبعده	يستبعد ه
يستحقه	يستحق ه
يستحقها	يستحق ها
يستخدمها	يستخدم ها
يستضيفها	يستضيف ها
يستطيعونه	يستطيعون ه
يستعمله	يستعمل ه
يستعملها	يستعمل ها
يستغربه	يستغرب ه
يستغلها	يستغلها يستغلها
يستوردها	يستورد ها
يسرنا	يسر نا
يسكنها	يسكن ها
يسلمه	يسلم ه
يسمها	يسم ها
يسميه	يسمي ه
يسوده	يسود ه
يسودها	يسود ها
يسوقها	يسوق ها
يسير	يسير عبر
يشجعها	يشجع ها
يشنها	يشن ها
يشهده	يشهد ه
يشهدها	يشهد ها
يشيده	يشيد ه
يصدرها	يصدر ها
يصدمني	يصدمني يصدمني
يضعه	يضع ه
يضعها	يضع ها
يضيفه	يضيف ه
يطالبهم	يطالب هم
يطبعه	يطبع ه
يطلبه	يطلب ه
يعتبرها	يعتبر ها
يعرضها	يعرض ها
يعرضهم	يعرض هم
يعرفها	يعرف ها
يعرفونه	يعرفون ه
يعطينا	يعطينا يعطينا
يعنيه	يعني ه
يعيده	يعيد ه
يعيشه	يعيش ه
يعيشها	يعيش ها
يفتتحه	يفتتح ه
يفرحهم	يفرح هم
يفرزها	يفرز ها
يفصلها	يفصل ها
يفكر	يفكر في
يفهمها	يفهم ها
يقاطعه	يقاطع ه
يقترحها	يقترح ها
يقتله	يقتل ه
يقدره	يقدر ه
يقدمه	يقدم ه
يقدمها	يقدم ها
يقدمونها	يقدمون ها
يقرره	يقرر ه
يقرها	يقر ها
يقـــتنونها	يقتنون ها
يقفها	يقف ها
يقوده	يقود ه
يقودها	يقود ها
يقولونه	يقولون ه
يقيلها	يقيل ها
يقيمها	يقيم ها
يقيمونها	يقيمون ها
يكفله	يكفل ه
يلتزمه	يلتزم ه
يلعبه	يلعب ه
يليه	يلي ه
يمتلكها	يمتلك ها
يمثله	يمثل ه
يمكنك	يمكن ك
يمكننا	يمكن نا
يمكنني	يمكنني يمكنني
يمكنه	يمكن ه
يمكنها	يمكن ها
يمكنهما	يمكنهما يمكنهما
يملكه	يملك ه
ينادوه	ينادوا ه
ينتظره	ينتظر ه
ينتقدانه	ينتقدان ه
ينظمه	ينظم ه
ينفذها	ينفذ ها
ينقصها	ينقص ها
ينكره	ينكر ه
يهددها	يهدد ها
يهدني	يهدني يهدني
يهزه	يهزه يهزه
يواجهها	يواجه ها
يواكبه	يواكب ه
يوبيلها	يوبيل ها
يوردها	يورد ها
يوقعها	يوقع ها
يوليها	يولي ها
يومه	يوم ه
يُحبانه	يحبان ه
