abbattersi	abbatter si
abbatterti	abbatter ti
abbuffarsi	abbuffar si
abitarla	abitar la
abituarci	abituar ci
accanirsi	accanir si
accomodarsi	accomodar si
accontentarci	accontentar ci
accontentarsi	accontentar si
accoppiarlo	accoppiar lo
accordandosi	accordando si
accorgersi	accorger si
accostarsi	accostar si
accreditarsi	accreditar si
accrescerne	accrescer ne
accumularsi	accumular si
acquistarsi	acquistar si
adattarsi	adattar si
addolorarci	addolorar ci
adeguarsi	adeguar si
adempierle	adempier le
aderirvi	aderir vi
adoperarsi	adoperar si
adottarlo	adottar lo
adottarsi	adottar si
adunarsi	adunar si
affacciarsi	affacciar si
affermarsi	affermar si
affievolirsi	affievolir si
affiliarsi	affiliar si
agli	a gli
ai	a i
aiutarle	aiutar le
aiutarli	aiutar li
aiutarlo	aiutar lo
aiutarsi	aiutar si
al	a il
all'	a l'
alla	a la
allargarne	allargar ne
alle	a le
allo	a lo
allontanandosi	allontanando si
allontanarsi	allontanar si
all’	a l’
alterarne	alterar ne
alzarvi	alzar vi
ammalatasi	ammalata si
ammetterlo	ammetter lo
ammucchiatovi	ammucchiato vi
ampliarlo	ampliar lo
analizzandolo	analizzando lo
andarci	andar ci
andargli	andar gli
andarsene	andar se ne
animarsi	animar si
appartarsi	appartar si
applicarmi	applicar mi
applicarsi	applicar si
appoggiandovi	appoggiando vi
appoggiarvi	appoggiar vi
appostarsi	appostar si
approfittarne	approfittar ne
appropriandosi	appropriando si
aprendosi	aprendo si
aprirle	aprir le
aprirne	aprir ne
aprirvi	aprir vi
arginarli	arginar li
arrabbiarti	arrabbiar ti
arrendersi	arrender si
arrestarsi	arrestar si
asciugandosi	asciugando si
ascoltarle	ascoltar le
assegnandone	assegnando ne
assicurandosi	assicurando si
assicurarci	assicurar ci
assicurarne	assicurar ne
assicurati	assicura ti
assisterli	assister li
associarsi	associar si
assumersi	assumer si
attaccarli	attaccar li
attendersi	attender si
attribuirsi	attribuir si
aumentarne	aumentar ne
autodefinendosi	autodefinendo si
averci	aver ci
averla	aver la
averli	aver li
averlo	aver lo
averne	aver ne
avvalendosi	avvalendo si
avvalersi	avvaler si
avventurarsi	avventurar si
avvicinarci	avvicinar ci
avvicinarsi	avvicinar si
baciarle	baciar le
basandosi	basando si
basarsi	basar si
batterci	batter ci
candidarlo	candidar lo
candidarsi	candidar si
capirmi	capir mi
cercarsi	cercar si
chiamateli	chiamate li
chiedendole	chiedendo le
chiederle	chieder le
chiederne	chieder ne
chiediti	chiedi ti
chiuderlo	chiuder lo
citarne	citar ne
cogli	con gli
coi	con i
coinvolgerci	coinvolger ci
coinvolgersi	coinvolger si
col	con il
colla	con la
colle	con le
collegarsi	collegar si
colpendolo	colpendo lo
combinarlo	combinar lo
commuoversi	commuover si
comperarli	comperar li
completandole	completando le
complicarsi	complicar si
complimentarsi	complimentar si
comportarci	comportar ci
comportarsi	comportar si
comprarle	comprar le
comprarsi	comprar si
concediti	concedi ti
concentrarsi	concentrar si
concentrarti	concentrar ti
condiscili	condisci li
conferitegli	conferite gli
confermandogli	confermando gli
confessarle	confessar le
configurarsi	configurar si
conformandosi	conformando si
conformarsi	conformar si
congedarsi	congedar si
congiungendosi	congiungendo si
congratularmi	congratular mi
congratularsi	congratular si
connetterti	connetter ti
connettiti	connetti ti
conquistarci	conquistar ci
conquistarvi	conquistar vi
consegnarla	consegnar la
consentendoci	consentendo ci
consentirci	consentir ci
conservarli	conservar li
conservarsi	conservar si
conserviamoli	conserviamo li
considerandoli	considerando li
considerandolo	considerando lo
considerarsi	considerar si
consigliargli	consigliar gli
consumarsi	consumar si
continuarla	continuar la
contribuirvi	contribuir vi
controllarle	controllar le
coprirne	coprir ne
corrispondergli	corrisponder gli
corrispondergliene	corrisponder glie ne
corroderne	corroder ne
costituirsi	costituir si
costringerla	costringer la
costringerlo	costringer lo
costruirli	costruir li
costruirlo	costruir lo
crearla	crear la
crearsi	crear si
createsi	create si
crogiolarsi	crogiolar si
curali	cura li
curarsi	curar si
custodirla	custodir la
dagli	da gli
dai	da i
dal	da il
dall'	da l'
dalla	da la
dalle	da le
dallo	da lo
dall’	da l’
darla	dar la
darmi	dar mi
darsi	dar si
de'	di i
dedicarci	dedicar ci
dedicarsi	dedicar si
definendolo	definendo lo
definirli	definir li
definirlo	definir lo
definirsi	definir si
degli	di gli
dei	di i
del	di il
dell'	di l'
della	di la
delle	di le
dello	di lo
dell’	di l’
deluderli	deluder li
depositarsi	depositar si
deprimersi	deprimer si
derivarsi	derivar si
des	de les
desumersi	desumer si
deteriorandoli	deteriorando li
determinandosi	determinando si
determinarsi	determinar si
diciamolo	diciamo lo
difendersi	difender si
dimensionandolo	dimensionando lo
dimettersi	dimetter si
diminuirne	diminuir ne
dimostrargli	dimostrar gli
dimostrarlo	dimostrar lo
dirgli	dir gli
dirigerlo	diriger lo
dirla	dir la
dirlo	dir lo
dirmi	dir mi
dirti	dir ti
dirvi	dir vi
disegnandone	disegnando ne
disinteressandosi	disinteressando si
disperdendole	disperdendo le
disporne	dispor ne
dissolversi	dissolver si
dissuaderlo	dissuader lo
distrarti	distrar ti
diversificarsi	diversificar si
divertirle	divertir le
documentarlo	documentar lo
domandarglieli	domandar glie li
domandarsi	domandar si
dotarsi	dotar si
doverlo	dover lo
doverne	dover ne
doversene	dover se ne
doversi	dover si
eccitarli	eccitar li
eccoci	ecco ci
eccole	ecco le
eccolo	ecco lo
effettuarsi	effettuar si
elevarsi	elevar si
eliminala	elimina la
eliminarle	eliminar le
emanciparsi	emancipar si
esaltarla	esaltar la
esaminarlo	esaminar lo
esaurirsi	esaurir si
escluderle	escluder le
escluderlo	escluder lo
eseguirvi	eseguir vi
esercitarne	esercitar ne
esibirsi	esibir si
esigerla	esiger la
esimersi	esimer si
esporsi	espor si
esprimersi	esprimer si
essendomi	essendo mi
esserci	esser ci
essergli	esser gli
esserlo	esser lo
esserne	esser ne
essersi	esser si
esserti	esser ti
esservi	esser vi
estendersi	estender si
estinguersi	estinguer si
estrarlo	estrar lo
eternarsi	eternar si
evidenziandone	evidenziando ne
evitarne	evitar ne
evitarsi	evitar si
evolversi	evolver si
fabbricarne	fabbricar ne
fabbricarvi	fabbricar vi
facendole	facendo le
facendone	facendo ne
facendosi	facendo si
facilitarne	facilitar ne
fargliene	far glie ne
farla	far la
farle	far le
farli	far li
farlo	far lo
farne	far ne
farsi	far si
farvi	far vi
fatemene	fate me ne
fatti	fat ti
favorendone	favorendo ne
ferendone	ferendo ne
fermarmi	fermar mi
fermarsi	fermar si
fermiamolo	fermiamo lo
fidarsene	fidar se ne
fidarsi	fidar si
figuriamoci	figuriamo ci
finirci	finir ci
finirlo	finir lo
focalizzali	focalizza li
formarsi	formar si
formatasi	formata si
formatisi	formati si
formatosi	formato si
garantirne	garantir ne
garantirsi	garantir si
gettarvi	gettar vi
girandola	girando la
girandolo	girando lo
gliel'	glie l'
gliela	glie la
glieli	glie li
glielo	glie lo
gratificandoti	gratificando ti
gridandomi	gridando mi
guardarsi	guardar si
idratala	idrata la
ignorarci	ignorar ci
illustrandovi	illustrando vi
imbarcarsi	imbarcar si
imbattersi	imbatter si
imbrogliarci	imbrogliar ci
immaginali	immagina li
immaginargli	immaginar gli
immaginarlo	immaginar lo
immettervi	immetter vi
impadronirsi	impadronir si
impedendoci	impedendo ci
impedirla	impedir la
impedirne	impedir ne
impegnarsi	impegnar si
impiantarsi	impiantar si
impiegarsi	impiegar si
imponendoti	imponendo ti
imporsi	impor si
impugnarlo	impugnar lo
inarcarsi	inarcar si
incendiandolo	incendiando lo
includervi	includer vi
incontrarsi	incontrar si
incoraggiarli	incoraggiar li
indicarla	indicar la
indurci	indur ci
indurlo	indur lo
infilarsi	infilar si
ingraziarsi	ingraziar si
inoltrandosi	inoltrando si
insegnarlo	insegnar lo
inseguirli	inseguir li
inserendovi	inserendo vi
inserirsi	inserir si
integrarsi	integrar si
intenderci	intender ci
intendersi	intender si
intendiamoci	intendiamo ci
interpellarlo	interpellar lo
interrogarlo	interrogar lo
interrompersi	interromper si
intitolarlo	intitolar lo
intrattenersi	intrattener si
invitarla	invitar la
invitarli	invitar li
irrigarlo	irrigar lo
iscriversi	iscriver si
iscriverti	iscriver ti
isolarsi	isolar si
ispirandosi	ispirando si
istituirsi	istituir si
lasciamoli	lasciamo li
lasciandoli	lasciando li
lasciarle	lasciar le
lasciarlo	lasciar lo
lasciarne	lasciar ne
lasciatagli	lasciata gli
lasciatemi	lasciate mi
lavarli	lavar li
lavarsi	lavar si
laviamoci	laviamo ci
leggergli	legger gli
leggersi	legger si
levarle	levar le
levarsi	levar si
liberarlo	liberar lo
liberarsene	liberar se ne
liberarsi	liberar si
limitandosi	limitando si
limitarsi	limitar si
lusingarlo	lusingar lo
mandarlo	mandar lo
mangiandoselo	mangiando se lo
mangiandosi	mangiando si
manifestarsi	manifestar si
mantenerli	mantener li
mantenerne	mantener ne
mantenersi	mantener si
mescolandolo	mescolando lo
mescolarlo	mescolar lo
mettendolo	mettendo lo
mettendosi	mettendo si
metterlo	metter lo
metterne	metter ne
mettersi	metter si
mettetele	mettete le
mettiamole	mettiamo le
migliorarlo	migliorar lo
migliorarne	migliorar ne
misurarne	misurar ne
misurarsi	misurar si
moltiplicarle	moltiplicar le
mostrandola	mostrando la
mostrandosi	mostrando si
mostrarla	mostrar la
multiplexarlo	multiplexar lo
muoversi	muover si
nasconderci	nasconder ci
nascondersi	nasconder si
nascondiamoci	nascondiamo ci
negli	in gli
nei	in i
nel	in il
nell'	in l'
nella	in la
nelle	in le
nello	in lo
nell’	in l’
notificarlo	notificar lo
nutrendosi	nutrendo si
nutrirne	nutrir ne
obbligarsi	obbligar si
occupandosi	occupando si
occuparci	occupar ci
occuparla	occupar la
occuparle	occupar le
occuparsene	occupar se ne
occuparsi	occupar si
occupiamoci	occupiamo ci
offertegli	offerte gli
offertogli	offerto gli
offrirsi	offrir si
omettendola	omettendo la
opporgli	oppor gli
opporsi	oppor si
organizzandosi	organizzando si
organizzarsi	organizzar si
osservarne	osservar ne
osservarsi	osservar si
osservati	osserva ti
ossigenarsi	ossigenar si
ossigenarti	ossigenar ti
ottenerli	ottener li
ottenerne	ottener ne
ottenersi	ottener si
pagandone	pagando ne
pagarne	pagar ne
pagarsi	pagar si
paragonarsi	paragonar si
parlarne	parlar ne
parlarvi	parlar vi
passandolo	passando lo
passandosi	passando si
pel	per il
pensaci	pensa ci
pensarlo	pensar lo
pensarsi	pensar si
pensatti	pensat ti
perdersi	perder si
permettendole	permettendo le
permettergli	permetter gli
permetterla	permetter la
permetterle	permetter le
permetterselo	permetter se lo
permettersi	permetter si
permettetemi	permettete mi
picchiarsi	picchiar si
porsi	por si
portandosi	portando si
portandovi	portando vi
portarlo	portar lo
portarmi	portar mi
portarsi	portar si
potendosi	potendo si
poterli	poter li
poterlo	poter lo
potersi	poter si
poterti	poter ti
prefiggerci	prefigger ci
prendendosi	prendendo si
prendergli	prender gli
prenderla	prender la
prenderli	prender li
prenderne	prender ne
prendersi	prender si
prendila	prendi la
prepararci	preparar ci
presentarli	presentar li
presentarlo	presentar lo
prevedersi	preveder si
procacciarsi	procacciar si
procedersi	proceder si
procurarla	procurar la
procurarsela	procurar se la
procurarsi	procurar si
produrle	produr le
profondarne	profondar ne
promuoversi	promuover si
pronunciarci	pronunciar ci
pronunciarsi	pronunciar si
propagandosi	propagando si
propagarsi	propagar si
proponendosi	proponendo si
proteggerlo	protegger lo
provocandone	provocando ne
provocarne	provocar ne
provvedersi	provveder si
provvedervi	provveder vi
quantificarne	quantificar ne
raggiungersi	raggiunger si
rallentarne	rallentar ne
rammaricarsi	rammaricar si
rassegnarci	rassegnar ci
rassegnarsi	rassegnar si
rassodalo	rassoda lo
ravvedersi	ravveder si
recarsi	recar si
recuperarla	recuperar la
regalarle	regalar le
regalarli	regalar li
regalati	regala ti
registrarsi	registrar si
registrarti	registrar ti
reinventarsi	reinventar si
rendendole	rendendo le
renderla	render la
renderle	render le
renderli	render li
renderlo	render lo
renderne	render ne
rendersi	render si
resasi	resa si
respingerlo	respinger lo
restarci	restar ci
restarsene	restar se ne
restituirla	restituir la
restituirle	restituir le
restituirne	restituir ne
riaverli	riaver li
ribellarsi	ribellar si
ricaricarti	ricaricar ti
ricavarla	ricavar la
riceverle	ricever le
riceverlo	ricever lo
riconoscilo	riconosci lo
riconosciutagli	riconosciuta gli
ricordandone	ricordando ne
ricordarci	ricordar ci
ricordargli	ricordar gli
ricordarmi	ricordar mi
ricordarvi	ricordar vi
ricordati	ricorda ti
ricostruirlo	ricostruir lo
ricredersi	ricreder si
ricusarlo	ricusar lo
ridurlo	ridur lo
riempiendolo	riempiendo lo
riempirli	riempir li
rientrarvi	rientrar vi
rifarti	rifar ti
riferirsi	riferir si
rifiutarsi	rifiutar si
rifugiandosi	rifugiando si
rifugiatisi	rifugiati si
rigonfiandosi	rigonfiando si
rilassarsi	rilassar si
rilevarla	rilevar la
rimanervi	rimaner vi
rimetterci	rimetter ci
rimetterle	rimetter le
rimettersi	rimetter si
rimodellarci	rimodellar ci
rinforzandolo	rinforzando lo
rinforzarlo	rinforzar lo
ringraziarlo	ringraziar lo
rinnovarlo	rinnovar lo
rinunziarvi	rinunziar vi
ripararci	riparar ci
ripararli	riparar li
ripetersi	ripeter si
riportarsi	riportar si
riposarsi	riposar si
riprenderli	riprender li
riprendersi	riprender si
ripresentarsi	ripresentar si
riprodursi	riprodur si
risarcirgli	risarcir gli
risolverla	risolver la
rispettarne	rispettar ne
risponderle	risponder le
ritenerle	ritener le
ritenerli	ritener li
ritenerlo	ritener lo
ritirarlo	ritirar lo
ritirarsi	ritirar si
ritrovarci	ritrovar ci
ritrovarsi	ritrovar si
riunirsi	riunir si
rivelarne	rivelar ne
rivelarsi	rivelar si
rivendicarli	rivendicar li
rivolgendosi	rivolgendo si
rivolgerle	rivolger le
rivolgersi	rivolger si
rompersi	romper si
salvarsi	salvar si
saperlo	saper lo
sapernne	sapern ne
sbagliarci	sbagliar ci
sbizzarrirsi	sbizzarrir si
scambiarsi	scambiar si
scannarsi	scannar si
scavarne	scavar ne
schiaffaci	schiaffa ci
schiantandosi	schiantando si
scontrandosi	scontrando si
scontrarsi	scontrar si
scortarlo	scortar lo
scriverle	scriver le
sdraiandosi	sdraiando si
sedersi	seder si
seguirlo	seguir lo
seguirmi	seguir mi
sentirsi	sentir si
servirmi	servir mi
servirsene	servir se ne
servirsi	servir si
sforzarsi	sforzar si
sfracellandosi	sfracellando si
sfracellarsi	sfracellar si
sfuggirgli	sfuggir gli
sganciarla	sganciar la
sintonizzarci	sintonizzar ci
smetterla	smetter la
sollecitandone	sollecitando ne
sopportarne	sopportar ne
sorprendersi	sorprender si
sostenendone	sostenendo ne
sostenerle	sostener le
sosteneteci	sostenete ci
sostituirlo	sostituir lo
sostituirne	sostituir ne
sostituirsi	sostituir si
sottoporsi	sottopor si
sottrarsi	sottrar si
sovrapporsi	sovrappor si
sovvertirlo	sovvertir lo
sparandola	sparando la
specializzarsi	specializzar si
spianiamola	spianiamo la
spiegarlo	spiegar lo
spingersi	spinger si
sposarsi	sposar si
spostarsi	spostar si
sprecarla	sprecar la
stabilirlo	stabilir lo
stabilirsi	stabilir si
stabilitosi	stabilito si
stamparlo	stampar lo
starmene	star me ne
starsene	star se ne
sterminarci	sterminar ci
strapazzarlo	strapazzar lo
strapparsi	strappar si
strofinarla	strofinar la
studiarli	studiar li
subirne	subir ne
suddividersi	suddivider si
sugli	su gli
sui	su i
suicidarsi	suicidar si
sul	su il
sull'	su l'
sulla	su la
sulle	su le
sullo	su lo
superarlo	superar lo
surgeliamoli	surgeliamo li
surrogarlo	surrogar lo
svilupparli	sviluppar li
svolgersi	svolger si
svoltesi	svolte si
tagliali	taglia li
tagliamole	tagliamo le
tagliarli	tagliar li
telefonarle	telefonar le
temerne	temer ne
tenerla	tener la
tenerlo	tener lo
tenersi	tener si
tenutasi	tenuta si
toccarlo	toccar lo
toglierla	toglier la
toglierle	toglier le
togliersela	toglier se la
togliersi	toglier si
tonificalo	tonifica lo
tradurla	tradur la
trarne	trar ne
trascinarsi	trascinar si
trasformandoli	trasformando li
trasformarsi	trasformar si
trattale	tratta le
trattandosi	trattando si
trattarsi	trattar si
trattenersi	trattener si
travestirsi	travestir si
trovarci	trovar ci
trovarla	trovar la
trovarselo	trovar se lo
trovarsi	trovar si
tuffarsi	tuffar si
ucciderti	uccider ti
uniformarsi	uniformar si
unirli	unir li
unirsi	unir si
unitosi	unito si
usale	usa le
usalo	usa lo
usarla	usar la
usarlo	usar lo
usarne	usar ne
utilizzarla	utilizzar la
utilizzarle	utilizzar le
utilizzarli	utilizzar li
valendosi	valendo si
valersi	valer si
valutarsi	valutar si
variarne	variar ne
variarsi	variar si
vedendoselo	vedendo se lo
vedendosi	vedendo si
vederci	veder ci
vedergli	veder gli
vederli	veder li
vederlo	veder lo
vedermi	veder mi
vedersi	veder si
venderla	vender la
vendicarsi	vendicar si
verificarsi	verificar si
verificatasi	verificata si
verificatesi	verificate si
verificatisi	verificati si
versatigli	versati gli
vietarle	vietar le
visitarli	visitar li
volerne	voler ne
