1970'li	1970 'li
20'li	20 'li
3'lük	_ 3'lük
30'lu	30 'lu
?anlışlanabilirlik	? anlışlanabilirlik
?anlışlanabilirliği	? anlışlanabilirliği
?aveau'daki	? aveau'daki
?edir	? edir
?erdeydin	? erdeydin
?eredesin	? eredesin
?eredesiniz	? eredesiniz
?eredeydi	? eredeydi
?etinlerdir	? etinlerdir
?eydi	? eydi
?eymiş	? eymiş
?immiş	? immiş
?imsiniz	? imsiniz
?irerken	? irerken
?lırsınız	? lırsınız
?ostakoviç'miş	? ostakoviç'miş
adamdı	adam dı
adamlarız	adamlar ız
adlı	ad lı
adsız	ad sız
aittir	ait tir
akp'li	akp 'li
akp'lilerin	akp 'li lerin
akımdır	akım dır
alacalı	alaca lı
alandaki	alanda ki
alanıdır	alanı dır
aldatmacadır	aldatmaca dır
aldı	al dı
algıdır	algı dır
algılayıcı	algıla yıcı
almanya'daki	almanya'da ki
altındaki	altında ki
alıcı	al ıcı
alıverişlerdir	alıveriş lerdir
alışıktı	alışık tı
andı	an dı
anlayana	anlayan a
apandisti	apandis ti
aptalca	aptal ca
aracılığıyladır	aracılığıyla dır
aralarındaki	aralarında ki
aranızdaki	aranızda ki
arasındaki	arasında ki
ardındaki	ardında ki
arkadaki	arkada ki
arkadaşlardır	arkadaş lardır
arkadaştılar	arkadaş tılar
arkadaşım	arkadaş ım
arkasındaki	arkasında ki
artırıcı	artır ıcı
arınınki	arının ki
asırdır	asır dır
atılmış	atıl mış
atılımdır	atılım dır
avrupa'daki	avrupa'da ki
ayaklardaki	ayaklarda ki
aydır	ay dır
ayhan'dı	ayhan 'dı
ayrımındalar	ayrımında lar
ayınınki	ayının ki
azaltıcı	azalt ıcı
açmazlarla	açmaz larla
açıktır	açık tır
açıkça	açık ça
ağaçlıklı	ağaçlık lı
ağaçtaydı	ağaçta ydı
ağdı	ağ dı
ağzındaymış	ağzında ymış
ağırlıklı	ağırlık lı
aşağıdaki	aşağıda ki
aşağıdaydı	aşağıda ydı
aşıkmışsın	aşık mışsın
aşığıyım	aşığı yım
bakıştılar	bakış tılar
bağlayıcı	bağla yıcı
bağlıydı	bağlı ydı
bağımlıdır	bağımlı dır
başkaydı	başka ydı
başlangıcıdır	başlangıcı dır
başlangıçtaki	başlangıçta ki
başlıklı	başlık lı
başlıktaki	başlıkta ki
başındaki	başında ki
bekardı	bekar dı
belindeki	belinde ki
belliydi	belli ydi
bendeki	bende ki
bendim	ben dim
benim	ben im
benimki	benim ki
bense	ben se
besbelliydi	besbelli ydi
beyindir	beyin dir
beğenili	beğeni li
bilene	bilen e
bilenler	bilen ler
bileşenleri	bileşen leri
bilimcidir	bilimci dir
binikiyuz'lü	binikiyuz 'lü
biridir	biri dir
birisiyse	biri siyse
bitenleri	biten leri
bizimkiler	bizim kiler
bizimkinde	bizim kinde
bizleledir	bizle ledir
bizler	biz ler
bohemiydi	bohemi ydi
boyalı	boya lı
boyluydu	boylu ydu
budur	bu dur
bugünkü	bugün kü
bulanıkken	bulanık ken
bulvarındaaki	bulvarında aki
buradaki	burada ki
buradaydı	burada ydı
buradaymışım	burada ymışım
burunlu	burun lu
buydu	bu ydu
buzlu	buz lu
buzluktaki	buzlukta ki
bölgedeki	bölgede ki
böyledir	böyle dir
böyleyse	böyle yse
bürokrattır	bürokrat tır
büyükleriydi	büyükleri ydi
büyükmüş	büyük müş
bıyıklı	bıyık lı
caddelerindeydim	caddelerinde ydim
caddesindeeki	caddesinde eki
camlı	cam lı
cebimdeki	cebimde ki
cebindeki	cebinde ki
celseydi	celse ydi
ceza'ydı	ceza 'ydı
chp'liler	chp 'li ler
chp'lilerin	chp 'li lerin
cimriymiş	cimri ymiş
cinayetsiz	cinayet siz
cumhurbaşkanıdır	cumhurbaşkanı dır
dairedeki	dairede ki
dalgalı	dalga lı
dalgınsın	dalgın sın
dallarındaysa	dallarında ysa
darbukalı	darbuka lı
darbukaydı	darbuka ydı
davranışlarıydı	davranışları ydı
davranışlı	davranış lı
dağdaki	dağda ki
dağlarıydı	dağları ydı
dağlık	dağ lık
dehşetli	dehşet li
delice	deli ce
demektir	demek tir
deneyebiliriz	deneyebilir iz
deneylerdir	deney lerdir
dergimizdeki	dergimizde ki
detaylı	detay lı
devrimsizlik	devrim siz lik
diyarbakır'daki	diyarbakır'da ki
dizgedeki	dizgede ki
dişilerdi	dişiler di
dolaptaki	dolapta ki
dolarlık	dolar lık
dolaylıdır	dolaylı dır
doluydu	dolu ydu
doluydum	dolu ydum
doluyum	dolu yum
doğruymuş	doğru ymuş
doğumevidir	doğumevi dir
doğumlu	doğum lu
durgundu	durgun du
durumdur	durum dur
durumuydu	durumu ydu
duyanlar	duyan lar
duygulardı	duygular dı
duygularıdır	duyguları dır
duyumsat�ncaya	duyumsat�nca ya
dönemidir	dönemi dir
dünkü	dün kü
dünyadaki	dünyada ki
düzlemdeki	düzlemde ki
düşünenler	düşünen ler
düşünürken	düşünür ken
dışardaaki	dışarda aki
dışındaki	dışında ki
ecedir	ece dir
edenden	eden den
edenler	eden ler
edici	ed ici
edilmişlik	edilmiş lik
ekipiz	ekip iz
elbiseli	elbise li
eldeki	elde ki
elektrikli	elektrik li
elindeki	elinde ki
ellerindeki	ellerinde ki
eminim	emin im
endişesiydi	endişesi ydi
entarili	entari li
erkektir	erkek tir
erkendi	erken di
eroinsiz	eroin siz
esastı	esas tı
eseridir	eseri dir
esprili	espri li
etiketli	etiket li
etkiliydi	etkili ydi
etli	et li
etmesiydi	etmesi ydi
etrafımızdaki	etrafımızda ki
etrafındakileri	etrafında kileri
evdedir	evde dir
evliydi	evli ydi
evrenbilimcidir	evrenbilimci dir
eğlenceli	eğlence li
eşitliklerinizdeki	eşitliklerinizde ki
eşittir	eşit tir
faizli	faiz li
faziletli	fazilet li
fedakarlıklar	fedakar lıklar
fiyatlarındaki	fiyatlarında ki
fotoğrafıydı	fotoğrafı ydı
gecedir	gece dir
geceki	gece ki
gelene	gelen e
geleni	gelen i
gelenle	gelen le
gelenleri	gelen leri
gelirlerindeki	gelirlerinde ki
genişliğindeki	genişliğinde ki
gençti	genç ti
gerekenleri	gereken leri
gerekçeli	gerekçe li
gerçeklerdi	gerçekler di
geçene	geçen e
geçenin	geçen in
geçenler	geçen ler
geçerken	geçer ken
geçerlidir	geçerli dir
geçirmekti	geçirmek ti
geçmiştekiler	geçmişte kiler
gibidir	gibi dir
gibileriyle	gibi leriyle
gibiydi	gibi ydi
gibiydim	gibi ydim
gibiyim	gibi yim
gidenin	giden in
gidenlerden	giden lerden
gidici	gid ici
giyimiydi	giyimi ydi
giyimli	giyim li
gizliydi	gizli ydi
griydi	gri ydi
göbekli	göbek li
görevim	görev im
görünendir	görünen dir
görünüştü	görünüş tü
görüşüdür	görüşü dür
gövdeninse	gövdenin se
gözleriydi	gözleri ydi
gözlü	göz lü
gözlüksüz	gözlük süz
gözlülüğünün	göz lü lüğünün
gündür	gün dür
güneşiymişçesine	güneşi ymişçesine
günkü	gün kü
gürültülü	gürültü lü
güvenliler	güven li ler
güzelidir	güzeli dir
güçtedir	güçte dir
haberindeki	haberinde ki
hafifçe	hafif çe
hakkındaki	hakkında ki
haklılar	haklı lar
haksızım	haksız ım
haldeydi	halde ydi
halleşmezsem	halleşmez sem
hastalıklı	hastalık lı
hastaydı	hasta ydı
havalıydı	havalı ydı
havuzdaki	havuzda ki
hayalindeki	hayalinde ki
hayatındaki	hayatında ki
hayırlı	hayır lı
hazırdı	hazır dı
hazırdım	hazır dım
hazırdırlar	hazır dırlar
hazırladığımız	hazırladığım ız
hizmetçisiydi	hizmetçisi ydi
hocayız	hoca yız
hoşgörülü	hoşgörü lü
hoşnuttum	hoşnut tum
hoştu	hoş tu
hummalı	humma lı
hükümetiydi	hükümeti ydi
hüzünlü	hüzün lü
hırpalayıcı	hırpala yıcı
ibarettir	ibaret tir
ifadedir	ifade dir
ilerideki	ileride ki
ilginçtir	ilginç tir
ilkedir	ilke dir
ilkeli	ilke li
imkansız	imkan sız
imkansızdı	imkansız dı
imkansızı	imkan sız ı
inananlar	inanan lar
inceler	ince ler
insansız	insan sız
insanıyım	insanı yım
irak'taki	irak'ta ki
iriydi	iri ydi
isteksizce	isteksiz ce
isteyenler	isteyen ler
iyice	iyi ce
iyisin	iyi sin
iyiydi	iyi ydi
içindeki	içinde ki
içindeydi	içinde ydi
içindeydik	içinde ydik
içindeydim	içinde ydim
içindeyim	içinde yim
içindeyiz	içinde yiz
içindi	için di
içinse	için se
işlemidir	işlemi dir
i̇ddialı	i̇ddia lı
i̇hracattaki	i̇hracatta ki
i̇mkb'deki	i̇mkb'de ki
i̇ngiltere'deki	i̇ngiltere'de ki
i̇yice	i̇yi ce
i̇yiyim	i̇yi yim
i̇şletmeciyim	i̇şletmeci yim
kabarıktı	kabarık tı
kacaktır	kacak tır
kadarını	kadar ını
kadarız	kadar ız
kadroyuz	kadro yuz
kadındı	kadın dı
kadınsa	kadın sa
kahverengiymiş	kahverengi ymiş
kalanın	kalan ın
kalemdeki	kalemde ki
kalmadır	kalma dır
kalıcı	kal ıcı
kapalıdır	kapalı dır
kapalılıktır	kapalılık tır
kapalıydı	kapalı ydı
kapanı	kapan ı
kapsamlı	kapsam lı
kapıdaki	kapıda ki
kapısındaki	kapısında ki
kararsız	karar sız
kardeşiz	kardeş iz
kareli	kare li
karlılık	kar lı lık
karlılığınız	kar lı lığınız
karışlık	karış lık
karışıktı	karışık tı
karşılaştıranlar	karşılaştıran lar
karşılıklı	karşılık lı
karşısındaki	karşısında ki
karşıyayız	karşıya yız
katana	katan a
kategorideki	kategoride ki
katlarındaki	katlarında ki
katlı	kat lı
katındaki	katında ki
kavramlardır	kavram lardır
kavrayıştır	kavrayış tır
kavrulmamışı	kavrulmamış ı
kayıtlı	kayıt lı
kazadaki	kazada ki
kazananların	kazanan ların
kazançlı	kazanç lı
kaçınılmazlıktır	kaçınılmazlık tır
kağıtlık	kağıt lık
kenardaki	kenarda ki
kenardakilere	kenarda kilere
kenarındaki	kenarında ki
kendinleydi	kendinle ydi
kentli	kent li
keyifli	keyif li
keşkeymiş	keşke ymiş
kilitli	kilit li
kiralık	kira lık
kokulu	koku lu
kolayca	kolay ca
koludur	kolu dur
komşundur	komşun dur
konusundaki	konusunda ki
konuttur	konut tur
konuydu	konu ydu
kulağındaymış	kulağında ymış
kurtulana	kurtulan a
kurtulmaktı	kurtulmak tı
kuvvetli	kuvvet li
kuzeyli	kuzey li
kuşunki	kuşun ki
kölemdi	kölem di
kölesinizdir	köle sinizdir
köpeğiydi	köpeği ydi
kısaca	kısa ca
kısmetse	kısmet se
kısmıydı	kısmı ydı
kıyafetli	kıyafet li
kıyısındaki	kıyısında ki
lezizdir	leziz dir
liralık	_ liralık
mahallelerindeki	mahallelerinde ki
mahallesindeki	mahallesinde ki
mahkemesindeeki	mahkemesinde eki
malumdur	malum dur
mantıklıydı	mantık lı ydı
marks'ın	mark s'ın
masadaki	masada ki
memnundum	memnun dum
merasimsizlik	merasim siz lik
merkezindeki	merkezinde ki
mersedes'liden	mersedes 'li den
mesafeli	mesafe li
metafiziktir	metafizik tir
mevkiindeki	mevkiinde ki
mevzuattaki	mevzuatta ki
mezunuyum	mezunu yum
milas'lı	milas 'lı
milyarlık	milyar lık
motordaki	motorda ki
muhabbetliydi	muhabbet li ydi
muhtaçız	muhtaç ız
mutluydu	mutlu ydu
mutluydum	mutlu ydum
müdürdüm	müdür düm
mühendisiydiler	mühendisi ydiler
münasebetsizse	münasebetsiz se
münasiptir	münasip tir
müsteşarınınnki	müsteşarının nki
mütevaziliğin	mütevazi liğin
müzedeki	müzede ki
nasıldı	nasıl dı
nasıldır	nasıl dır
nasılsınız	nasıl sınız
nazikçe	nazik çe
netti	net ti
nicedir	nice dir
niteliğindeki	niteliğinde ki
nohuttur	nohut tur
ocaklı	ocak lı
odadaydılar	odada ydılar
odur	o dur
okuldansınız	okuldan sınız
okurken	okur ken
olandır	olan dır
olanlar	olan lar
olanları	olan ları
olanların	olan ların
olanı	olan ı
olaydı	olay dı
olduğudur	olduğu dur
olgudur	olgu dur
olmaktı	olmak tı
olmamasıdır	olmaması dır
oluşturulmasıdır	oluşturulması dır
onbir'lik	onbir 'lik
ondadır	onda dır
onlardaki	onlarda ki
onsuz	on suz
onunkini	onun kini
onurlu	onur lu
oradaki	orada ki
oradalar	orada lar
oradaydı	orada ydı
oranlarındaki	oranlarında ki
oranlı	oran lı
ormandaki	ormanda ki
ormanlık	orman lık
ortasındaki	ortasında ki
otlu	ot lu
oturana	oturan a
oydu	o ydu
parktaki	parkta ki
parmaklı	parmak lı
partiyiz	parti yiz
parçacıklarsa	parçacıklar sa
perisiydim	perisi ydim
perişanım	perişan ım
pervanelerdeki	pervanelerde ki
pervasızlar	pervasız lar
pilli	pil li
pilotuydu	pilotu ydu
plaklardaki	plaklarda ki
plandaki	planda ki
pompalı	pompa lı
prensesiyim	prensesi yim
prensibidir	prensibi dir
puslu	pus lu
pırıltılı	pırıltı lı
rahatlatıcı	rahatlat ıcı
rahatça	rahat ça
rahatım	rahat ım
rahmindeki	rahminde ki
rakımlı	rakım lı
rapordaki	raporda ki
razıydım	razı ydım
rengindeydi	renginde ydi
resimlerdir	resim lerdir
riskti	risk ti
ritimli	ritim li
romandı	roman dı
rutubetli	rutubet li
röportajındaki	röportajında ki
saatlik	saat lik
saattir	saat tir
sabırsızca	sabır sız ca
sahipiz	sahip iz
saklı	sak lı
salatasıdır	salatası dır
sararmışlığıma	sararmış lığıma
sarmısaklı	sarmısak lı
sarılışımsa	sarılışım sa
satırlık	satır lık
satışıdır	satışı dır
savaşsız	savaş sız
savcıyım	savcı yım
savunmasız	savunma sız
saygılı	saygı lı
saygılıyım	saygı lı yım
saçlı	saç lı
sağlamaktı	sağlamak tı
sağlıklı	sağlık lı
sağyağlı	sağyağ lı
sağındaki	sağında ki
sebzedir	sebze dir
seferlik	sefer lik
sekssiz	seks siz
sektöründeki	sektöründe ki
senaryodur	senaryo dur
sendin	sen din
senem'di	senem 'di
seninki	senin ki
seninkinden	senin kinden
sertçe	sert çe
sessiz	ses siz
sessizce	ses siz ce
sevenler	seven ler
sevgilisiyim	sevgilisi yim
sevimliydi	sevimli ydi
seyredenler	seyreden ler
sezai'ydi	sezai 'ydi
siirt'teki	siirt'te ki
silahlı	silah lı
silahımdı	silahım dı
silici	sil ici
sisli	sis li
sistemli	sistem li
sitedeki	sitede ki
sizinki	sizin ki
sodalı	soda lı
sokak'taki	sokak'ta ki
sokaktaki	sokakta ki
sokaktayız	sokakta yız
soldaki	solda ki
solgundular	solgun dular
soluğaydı	soluğa ydı
soluğaydılar	soluğa ydılar
sonsuzca	sonsuz ca
sorunlu	sorun lu
sorunudur	sorunu dur
soruydu	soru ydu
soruşturmaydı	soruşturma ydı
soğuktur	soğuk tur
soğukça	soğuk ça
söylencedir	söylence dir
söylenirse	söylenir se
sözcüğüdür	sözcüğü dür
sürecidir	süreci dir
süredir	süre dir
süreli	süre li
süreçse	süreç se
süreçtir	süreç tir
sıkça	sık ça
sıkıcı	sık ıcı
sıkıdır	sıkı dır
sıkıntılı	sıkıntı lı
sımsıcaktı	sımsıcak tı
sınıftaki	sınıfta ki
sınırlıdır	sınır lı dır
sırasındaki	sırasında ki
sığınaktı	sığınak tı
tabaktakileri	tabakta kileri
tabağındakileri	tabağında kileri
tablolardır	tablo lardır
takipçiliktir	takipçilik tir
taksitli	taksit li
tamiratsa	tamirat sa
tanımamaktır	tanımamak tır
tanıyanlar	tanıyan lar
tanışanları	tanışan ları
taraflıdır	taraflı dır
tarafındaki	tarafında ki
tarafız	taraf ız
taralıydı	taralı ydı
tarihli	tarih li
tarihteki	tarihte ki
tartışmalı	tartışma lı
tarzıydı	tarzı ydı
tavırdır	tavır dır
tehlikeli	tehlike li
telli	tel li
tenli	ten li
teoridir	teori dir
teypteki	teypte ki
tiryakisidir	tiryakisi dir
toplantıdayken	toplantıda yken
toplantılarındaki	toplantılarında ki
toplayıcılığı	topla yıcı lığı
topuklu	topuk lu
tozlu	toz lu
trilyonluk	_ trilyonluk
tutsaksınız	tutsak sınız
tüketicilerdir	tüketici lerdir
türktür	türk tür
türkçedeki	türkçede ki
ucundaki	ucunda ki
ulaşana	ulaşan a
umutsuzdu	umutsuz du
ustadır	usta dır
uysalca	uysal ca
uyurkenki	uyurken ki
uzunca	uzun ca
vadeli	vade li
van'lıir	van 'lı ir
vardı	var dı
vardır	var dır
varken	var ken
varsa	var sa
vazgeçene	vazgeçen e
venüs'teydim	venüs'te ydim
venüs'teydin	venüs'te ydin
verici	ver ici
verişidir	verişi dir
vetolu	veto lu
yakıcı	yak ıcı
yakındaki	yakında ki
yakınmış	yakın mış
yakınırım	yakınır ım
yakışıklıydı	yakışıklı ydı
yalnızca	yalnız ca
yalnızdı	yalnız dı
yalnızken	yalnız ken
yanaydı	yanay dı
yandaki	yanda ki
yanlıştı	yanlış tı
yanlıştır	yanlış tır
yanımdaki	yanımda ki
yanındaki	yanında ki
yanındaydı	yanında ydı
yapana	yapan a
yapanların	yapan ların
yapmayanların	yapmayan ların
yapısıdır	yapısı dır
yapısındadır	yapısında dır
yaralı	yara lı
yaralılardan	yara lı lardan
yaratıcı	yarat ıcı
yaratıcılığının	yaratıcı lığının
yasadaki	yasada ki
yasasındaaki	yasasında aki
yasasındaki	yasasında ki
yataktayken	yatakta yken
yatkındı	yatkın dı
yavaşça	yavaş ça
yaşamaktı	yaşamak tı
yaşamındaki	yaşamında ki
yaşayanlar	yaşayan lar
yaşayanları	yaşayan ları
yaşlarındaki	yaşlarında ki
yaşındaki	yaşında ki
yaşındaydı	yaşında ydı
yaşındayken	yaşında yken
yaşındayım	yaşında yım
yedideeki	yedide eki
yemekteydik	yemekte ydik
yeniymiş	yeni ymiş
yepyeniyken	yepyeni yken
yerlilik	yerli lik
yeterliydi	yeterli ydi
yetkisindedir	yetkisinde dir
yirmibeş'lik	_ yirmibeş'lik
yirmilerindeki	yirmilerinde ki
yokken	yok ken
yoksa	yok sa
yoktu	yok tu
yoktur	yok tur
yoldaydık	yolda ydık
yorgundu	yorgun du
yorgundurlar	yorgun durlar
yorklu	york lu
yunanlıların	yunan lı ların
yunanlıymış	yunan lı ymış
yurdudur	yurdu dur
yöneliktir	yönelik tir
yönündeki	yönünde ki
yörelerdeki	yörelerde ki
yükseklikteki	yükseklikte ki
yüzyıldaki	yüzyılda ki
yüzündeki	yüzünde ki
yıldaki	yılda ki
yıldır	yıl dır
yılki	yıl ki
yıllardır	yıllar dır
zahmetli	zahmet li
zamandır	zaman dır
zamanki	zaman ki
zamankinden	zaman kinden
zayıftır	zayıf tır
zordu	zor du
zordur	zor dur
zorundasın	zorunda sın
zorundasınız	zorunda sınız
zorundaydınız	zorunda ydınız
zorundaymışız	zorunda ymışız
zorundayım	zorunda yım
zorundayız	zorunda yız
zorunluluktandı	zorunluluktan dı
çakıldı	çakıl dı
çalışkandırlar	çalışkan dırlar
çalışmakmış	çalışmak mış
çamurlu	çamur lu
çantanızdaki	çantanızda ki
çarpıcı	çarp ıcı
çarpıcıydı	çarpıcı ydı
çağrılıyım	çağrılı yım
çekinmesiz	çekinme siz
çelişmemesidir	çelişmemesi dir
çevredekilerin	çevrede kilerin
çevresindeki	çevresinde ki
çiftti	çift ti
çocuklarmış	çocuklar mış
çocuktum	çocuk tum
çocuğudur	çocuğu dur
çıkabilirdik	çıkabilir dik
çıkarsa	çıkar sa
ödüllü	ödül lü
ölümüdür	ölümü dür
önceki	önce ki
öncelikli	öncelik li
önemidir	önemi dir
önemli	önem li
önemlisi	önem li si
önlüğündeki	önlüğünde ki
önümüzdeki	önümüzde ki
önündeki	önünde ki
önündeydik	önünde ydik
örtüydü	örtü ydü
öylece	öyle ce
öyledir	öyle dir
öyleyse	öyle yse
özelliktir	özellik tir
özenli	özen li
özentili	özenti li
özgüdür	özgü dür
öğreticidir	öğretici dir
öğretmenim	öğretmen im
ücretsiz	ücret siz
ülkemizdeki	ülkemizde ki
üniversitelerdeki	üniversitelerde ki
ünlüdür	ünlü dür
üretici	üret ici
ürkütücü	ürküt ücü
ürünüdür	ürünü dür
üstlerdeki	üstlerde ki
üstümdekiler	üstümde kiler
üstündekiler	üstünde kiler
üveylik	üvey lik
üzereydim	üzere ydim
üzerindeki	üzerinde ki
üzerindeydim	üzerinde ydim
üzgünüm	üzgün üm
şalınmış	şalın mış
şekersiz	şeker siz
şeydi	şey di
şeydir	şey dir
şöyleydi	şöyle ydi
şüpheli	şüphe li
şıktım	şık tım
