آبرویت	آبروی ت
آب‌نباتش	آب‌نبات ش
آثارش	آثار ش
آخرش	آخر ش
آدمهاست	آدمها ست
آزادند	آزاد ند
آزاد‌ید	آزاد‌ ید
آسیب‌پذیرند	آسیب‌پذیر ند
آمدنش	آمدن ش
آمریکاست	آمریکا ست
آنجاست	آنجا ست
آنست	آن ست
آنند	آن ند
آن‌هاست	آن‌ها ست
اجتماعی‌مان	اجتماعی‌ مان
اجدادش	اجداد ش
اجراست	اجرا ست
اخلاقشان	اخلاق شان
اذیتش	اذیت ش
ارتباطش	ارتباط ش
ارتباطمان	ارتباط مان
ارزشهاست	ارزشها ست
اره‌اش	اره‌ اش
ازش	از ش
ازین	از ین
ازینها	از ینها
ازین‌هاست	از ین‌ها ست
استخوانند	استخوان ند
اسلامند	اسلام ند
اسلامی‌اند	اسلامی‌ اند
اسلحه‌هایشان	اسلحه‌های شان
اسمت	اسم ت
اسمش	اسم ش
اشتباهند	اشتباه ند
اصلش	اصل ش
اطاقش	اطاق ش
اعلایش	اعلای ش
افتراست	افترا ست
افطارت	افطار ت
اقوامش	اقوام ش
اموالش	اموال ش
امیدوارم	امیدوار م
امیدوارند	امیدوار ند
امیدواریم	امیدوار یم
انتخابهایم	انتخابهای م
انتظارم	انتظار م
انجمنم	انجمن م
انشایش	انشای ش
انگشتشان	انگشت شان
انگشتهایش	انگشتهای ش
اهمیتشان	اهمیت شان
اوایلش	اوایل ش
اوست	او ست
اولش	اول ش
اولشان	اول شان
اولم	اول م
اکثرشان	اکثر شان
ایتالیاست	ایتالیا ست
اینجاست	اینجا ست
این‌هاست	این‌ها ست
بابات	بابا ت
بازیگرانش	بازیگران ش
بازیگرمان	بازیگر مان
بازیگرهایم	بازیگرهای م
بازی‌اش	بازی‌ اش
بالاست	بالا ست
باورتان	باور تان
باورند	باور ند
بجاست	بجا ست
بخشه	بخش ه
بدان	ب دان
بدش	بد ش
بدشان	بد شان
بدنم	بدن م
بدهی‌ات	بدهی‌ ات
بدین	ب دین
برابرش	برابر ش
برادرت	برادر ت
برادرش	برادر ش
برادرم	برادر م
برایتان	برای تان
برایش	برای ش
برایشان	برای شان
برایم	برای م
برایمان	برای مان
برخوردارند	برخوردار ند
برنامه‌سازهاست	برنامه‌سازها ست
برهمش	برهم ش
برهنه‌اش	برهنه‌ اش
بزرگش	بزرگ ش
بزرگ‌تری	بزرگ‌تر ی
بساطش	بساط ش
بسته‌ایم	بسته‌ ‌ایم
بعدش	بعد ش
بعضیهایشان	بعضیهای شان
بعضی‌شان	بعضی شان
بقیه‌اش	بقیه‌ اش
بلندش	بلند ش
بناگوشش	بناگوش ش
بهت	به ت
بهترش	بهتر ش
بهترم	بهتر م
بهش	به ش
به‌شان	به‌ شان
بودمش	بودم ش
بودنش	بودن ش
بودن‌شان	بودن‌ شان
بچه‌اش	بچه‌ اش
بچه‌م	بچه‌ م
بچه‌هایش	بچه‌های ش
بیدارم	بیدار م
بی‌اطلاعند	بی‌اطلاع ند
بی‌اطلاعید	بی‌اطلاع ید
بی‌بهره‌اند	بی‌بهره‌ اند
بی‌تفاوتند	بی‌تفاوت ند
بی‌حسابش	بی‌حساب ش
بی‌نیش	بی‌نی ش
تأثیرش	تأثیر ش
تجربه‌هایم	تجربه‌های م
تحریم‌هاست	تحریم‌ها ست
تحولند	تحول ند
تخیلی‌اش	تخیلی‌ اش
ترسشان	ترس شان
ترکش	ترک ش
تشنه‌ت	تشنه‌ ت
تشکیلاتی‌اش	تشکیلاتی‌ اش
تعلقش	تعلق ش
تلاشمان	تلاش مان
تماشاگرش	تماشاگر ش
تمامشان	تمام شان
تنمان	تن مان
تنهایی‌اش	تنهایی‌ اش
توانایی‌اش	توانایی‌ اش
توجهش	توجه ش
توست	تو ست
توصیه‌اش	توصیه‌ اش
تیغه‌اش	تیغه‌ اش
جاست	جا ست
جامعه‌اند	جامعه‌ اند
جانم	جان م
جایش	جای ش
جایشان	جای شان
جدیدش	جدید ش
جرمزاست	جرمزا ست
جلوست	جلو ست
جلویش	جلوی ش
جنسش	جنس ش
جنس‌اند	جنس‌ اند
جگرش	جگر ش
حاضرم	حاضر م
حالتهایشان	حالتهای شان
حالیست	حالی ست
حالی‌مان	حالی‌ مان
حاکیست	حاکی ست
حرامزادگی‌اش	حرامزادگی‌ اش
حرفتان	حرف تان
حرفش	حرف ش
حرفشان	حرف شان
حرفم	حرف م
حرف‌های‌شان	حرف‌های‌ شان
حرکتمان	حرکت مان
حریفانشان	حریفان شان
حضورشان	حضور شان
حمایتش	حمایت ش
حواست	حواس ت
حواسش	حواس ش
حواسشان	حواس شان
حوصله‌مان	حوصله‌ مان
حکومتش	حکومت ش
حکومتشان	حکومت شان
حیفم	حیف م
خاندانش	خاندان ش
خانه‌اش	خانه‌ اش
خانه‌شان	خانه‌ شان
خانه‌مان	خانه‌ مان
خانه‌هایشان	خانه‌های شان
خانواده‌اش	خانواده‌ اش
خانواده‌ام	خانواده‌ ام
خانواده‌شان	خانواده‌ شان
خانواده‌هاست	خانواده‌ها ست
خداست	خدا ست
خدایش	خدای ش
خدایشان	خدای شان
خردسالش	خردسال ش
خروپفشان	خروپف شان
خسته‌ای	خسته‌ ای
خطت	خط ت
خوابمان	خواب مان
خواندنش	خواندن ش
خواهرش	خواهر ش
خوبش	خوب ش
خودت	خود ت
خودتان	خود تان
خودتو	خود ت
خودش	خود ش
خودشان	خود شان
خودم	خود م
خودمان	خود مان
خوردمان	خورد مان
خوردنشان	خوردن شان
خوشش	خوش ش
خوشوقتم	خوشوقت م
خونشان	خون شان
خویش	خوی ش
خویشتنم	خویشتن م
خیالش	خیال ش
خیسش	خیس ش
داراست	دارا ست
داستانهایش	داستانهای ش
دخترمان	دختر مان
دخیلند	دخیل ند
درباره‌ات	درباره ات
درباره‌اش	درباره‌ اش
دردش	درد ش
دردشان	درد شان
درسته	درست ه
درش	در ش
درون‌شان	درون‌ شان
درگاهت	درگاه ت
درین	در ین
دریچه‌هایش	دریچه‌های ش
دزدانش	دزدان ش
دستش	دست ش
دستمان	دست مان
دستهایشان	دستهای شان
دشمنند	دشمن ند
دشمنیشان	دشمنی شان
دشمنیم	دشمن یم
دفترش	دفتر ش
دفنشان	دفن شان
دلت	دل ت
دلش	دل ش
دلشان	دل شان
دلم	دل م
دلیلش	دلیل ش
دنبالش	دنبال ش
دنباله‌اش	دنباله‌ اش
دهاتی‌هایش	دهاتی‌های ش
دهانت	دهان ت
دهانش	دهان ش
دهنش	دهن ش
دورش	دور ش
دوروبریهاشان	دوروبریها شان
دوستانش	دوستان ش
دوستانشان	دوستان شان
دوستش	دوست ش
دومش	دوم ش
دویدنش	دویدن ش
دکورهایمان	دکورهای مان
دیرت	دیر ت
دیرم	دیر م
دین‌شان	دین‌ شان
دیواره‌هایش	دیواره‌های ش
دیوانه‌ای	دیوانه‌ ای
دیوی	دیو ی
دیگرمان	دیگر مان
ذهنش	ذهن ش
ذهنشان	ذهن شان
ذهنم	ذهن م
رئوسش	رئوس ش
راهشان	راه شان
راهگشاست	راهگشا ست
رایانه‌هایشان	رایانه‌های شان
رعایتشان	رعایت شان
رفتارش	رفتار ش
رفتارشان	رفتار شان
رفتارمان	رفتار مان
رفتارهاست	رفتارها ست
رفتارهایشان	رفتارهای شان
رفقایم	رفقای م
رقیق‌ترش	رقیق‌تر ش
رنجند	رنج ند
رهگشاست	رهگشا ست
رواست	روا ست
روبروست	روبرو ست
روحی‌اش	روحی‌ اش
روزنامه‌اش	روزنامه‌ اش
روزه‌ای	روزه‌ ای
روزه‌ایم	روزه‌ ایم
روزه‌ست	روزه‌ ست
روسری‌اش	روسری‌ اش
روشتان	روش تان
رویش	روی ش
زبانش	زبان ش
زحماتشان	زحمات شان
زدنهایشان	زدنهای شان
زرنگشان	زرنگ شان
زشتش	زشت ش
زشتکارانند	زشتکاران ند
زنبوری‌اش	زنبوری‌ اش
زندانم	زندان م
زندگانی‌اش	زندگانی‌ اش
زندگی‌اش	زندگی‌ اش
زندگی‌ام	زندگی‌ ام
زندگی‌شان	زندگی‌ شان
زنش	زن ش
زنند	زن ند
زیاده	زیاد ه
زیباست	زیبا ست
زیبایش	زیبای ش
زیبایی	زیبای ی
زیراندازش	زیرانداز ش
زیرک‌اند	زیرک‌ اند
زین	ز ین
سؤالتان	سؤال تان
سؤالم	سؤال م
سابقه‌اش	سابقه‌ اش
ساختنم	ساختن م
ساده‌اش	ساده‌ اش
ساده‌اند	ساده‌ اند
سازمانش	سازمان ش
ساعتم	ساعت م
سالته	سال ت ه
سالش	سال ش
سالهاست	سالها ست
ساکنند	ساکن ند
سبزشان	سبز شان
سبیل‌مان	سبیل‌ مان
ستم‌هایش	ستم‌های ش
سخته	سخت ه
سخنانش	سخنان ش
سخنانشان	سخنان شان
سخنتان	سخن تان
سخنش	سخن ش
سخنم	سخن م
سرزمینشان	سرزمین شان
سرش	سر ش
سرشان	سر شان
سرمایه‌دارهاست	سرمایه‌دارها ست
سرنوشتش	سرنوشت ش
سرنوشتشان	سرنوشت شان
سروتهش	سروته ش
سقمش	سقم ش
سنش	سن ش
سپاهش	سپاه ش
سیاسیشان	سیاسی شان
سیاه‌چاله‌هاست	سیاه‌چاله‌ها ست
شاخه‌هایشان	شاخه‌های شان
شالوده‌اش	شالوده‌ اش
شانه‌هایش	شانه‌های ش
شاهدند	شاهد ند
شاهدیم	شاهد یم
شاهکارهایش	شاهکارهای ش
شخصیتش	شخصیت ش
شدنشان	شدن شان
شعارهاشان	شعارها شان
شعورش	شعور ش
شغلش	شغل ش
شماست	شما ست
شمشیرش	شمشیر ش
شنیدنش	شنیدن ش
شوراست	شورا ست
شیرینترش	شیرینتر ش
شیرینه	شیرین ه
شیطان‌اند	شیطان‌ اند
صاحبش	صاحب ش
صحنه‌اش	صحنه‌ اش
صدایش	صدای ش
صددند	صدد ند
صندوق‌هاست	صندوق‌ها ست
صندوق‌هایش	صندوق‌های ش
صورتش	صورت ش
ضروری‌اند	ضروری‌ اند
ضمیرش	ضمیر ش
طرفش	طرف ش
طلسمش	طلسم ش
طوره	طور ه
عبارتند	عبارت ند
عزیزانتان	عزیزان تان
عزیزانش	عزیزان ش
عزیزش	عزیز ش
عشرت‌طلبی‌اش	عشرت‌طلبی‌ اش
عقبیم	عقب یم
علاقه‌اش	علاقه‌ اش
عمرش	عمر ش
عمرشان	عمر شان
عملش	عمل ش
عملی‌اند	عملی‌ اند
عمویت	عموی ت
عمویش	عموی ش
عمیقش	عمیق ش
عواملش	عوامل ش
عوضشان	عوض شان
غذایی‌شان	غذایی‌ شان
غریبه‌اند	غریبه‌ اند
غلامانش	غلامان ش
غلطهاست	غلطها ست
غیرخودی‌اند	غیرخودی‌ اند
فراموشتان	فراموش تان
فردی‌اند	فردی‌ اند
فرزندانش	فرزندان ش
فرزندانشان	فرزندان شان
فرزندش	فرزند ش
فرم‌هایش	فرم‌های ش
فرهنگی‌مان	فرهنگی‌ مان
فریادشان	فریاد شان
فضایی‌شان	فضایی‌ شان
فقیرشان	فقیر شان
فوری‌شان	فوری‌ شان
فکرم	فکر م
قائلند	قائل ند
قائلیم	قائل یم
قادرند	قادر ند
قانونمندش	قانونمند ش
قبلند	قبل ند
قبلی‌اش	قبلی‌ اش
قبلی‌مان	قبلی‌ مان
قدمش	قدم ش
قسمتش	قسمت ش
قضایاست	قضایا ست
قضیه‌شان	قضیه‌ شان
قهرمانهایشان	قهرمانهای شان
قهرمانیش	قهرمانی ش
قومت	قوم ت
لازمه‌اش	لازمه‌ اش
مأموریتش	مأموریت ش
مأموریتم	مأموریت م
مأموریت‌اند	مأموریت‌ اند
مادرانشان	مادران شان
مادرت	مادر ت
مادرش	مادر ش
مادرم	مادر م
ماست	ما ست
مالی‌اش	مالی‌ اش
مایی	ما یی
متفاوتند	متفاوت ند
مجازاتش	مجازات ش
مجبورند	مجبور ند
محتاجند	محتاج ند
محرمم	محرم م
محلش	محل ش
مخالفند	مخالف ند
مخدرش	مخدر ش
مدتهاست	مدتها ست
مدرسه‌ات	مدرسه ات
مدرسه‌م	مدرسه‌ م
مدرکم	مدرک م
مدیرانش	مدیران ش
مدیونم	مدیون م
مذهبی‌اند	مذهبی‌ اند
مرا	م را
مردمشان	مردم شان
مردمند	مردم ند
مردم‌اند	مردم‌ اند
مرده‌اند	مرده‌ اند
مرزشان	مرز شان
مرزهاشان	مرزها شان
مزدورش	مزدور ش
مسئولیتش	مسئولیت ش
مسائلش	مسائل ش
مستحضرید	مستحضر ید
مسلمانند	مسلمان ند
مشتریانش	مشتریان ش
مشتهایمان	مشتهای مان
مشخصند	مشخص ند
مشغولند	مشغول ند
مشغولیم	مشغول یم
مشهورش	مشهور ش
مشکلاتشان	مشکلات شان
مشکلم	مشکل م
مطمئنم	مطمئن م
معامله‌مان	معامله‌ مان
معتقدم	معتقد م
معتقدند	معتقد ند
معتقدیم	معتقد یم
معرفی‌اش	معرفی‌ اش
معروفش	معروف ش
معضلاتمان	معضلات مان
معلمش	معلم ش
معنایش	معنای ش
مفیدند	مفید ند
مقابلش	مقابل ش
مقاله‌اش	مقاله‌ اش
مقدمش	مقدم ش
مقرش	مقر ش
مقصدشان	مقصد شان
مقصرند	مقصر ند
مقصودتان	مقصود تان
مقصودم	مقصود م
ملاقاتهایش	ملاقاتهای ش
ممکنشان	ممکن شان
ممیزیهاست	ممیزیها ست
منظورم	منظور م
منی	من ی
منید	من ید
مواجهند	مواجه ند
مواجه‌اند	مواجه‌ اند
مواضعشان	مواضع شان
مواضعمان	مواضع مان
موافقند	موافق ند
موجوداتش	موجودات ش
موجودند	موجود ند
موردش	مورد ش
موضعشان	موضع شان
موظفند	موظف ند
موهایش	موهای ش
موهایمان	موهای مان
مویم	موی م
ناراحتیش	ناراحتی ش
ناراضی‌اند	ناراضی‌ اند
نازش	ناز ش
نامش	نام ش
نامشان	نام شان
نامم	نام م
نامه‌ات	نامه‌ ات
ناچارم	ناچار م
نزدش	نزد ش
نشانم	نشان م
نظرات‌شان	نظرات‌ شان
نظرتان	نظر تان
نظرش	نظر ش
نظرشان	نظر شان
نظرم	نظر م
نظرهایشان	نظرهای شان
نفاقش	نفاق ش
نفرند	نفر ند
نفوذیند	نفوذی ند
نمایشی‌مان	نمایشی‌ مان
نمایندگی‌شان	نمایندگی‌ شان
نمونه‌اش	نمونه‌ اش
نمی‌پذیرندش	نمی‌پذیرند ش
نوآوری‌اش	نوآوری‌ اش
نوشته‌هایشان	نوشته‌های شان
نوشته‌هایم	نوشته‌های م
نکردنشان	نکردن شان
نگاهداری‌شان	نگاهداری‌ شان
نگاهش	نگاه ش
نگرانم	نگران م
نگرشهایشان	نگرشهای شان
نیازمندند	نیازمند ند
هدفش	هدف ش
هدفشان	هدف شان
همانست	همان ست
همراهش	همراه ش
همسرتان	همسر تان
همسرش	همسر ش
همسرم	همسر م
همه‌اش	همه‌ اش
همه‌شان	همه‌ شان
همکارانش	همکاران ش
هم‌نظریم	هم‌نظر یم
هنرش	هنر ش
هواست	هوا ست
وابسته‌اند	وابسته‌ اند
واقفند	واقف ند
وطنم	وطن م
وعده‌اش	وعده‌ اش
وقتمان	وقت مان
ولادتش	ولادت ش
پایانش	پایان ش
پایش	پای ش
پایین‌ترند	پایین‌تر ند
پدرت	پدر ت
پدرش	پدر ش
پدرشان	پدر شان
پدرشوهرم	پدرشوهر م
پدرم	پدر م
پروردگارت	پروردگار ت
پسرت	پسر ت
پسرتان	پسر تان
پسرش	پسر ش
پسرعمویش	پسرعموی ش
پشتش	پشت ش
پشیمونی	پشیمون ی
پولش	پول ش
پژوهش‌هایش	پژوهش‌های ش
پیامبرش	پیامبر ش
پیامبری	پیامبر ی
پیداست	پیدا ست
پیروانش	پیروان ش
پیوندشان	پیوند شان
چاپش	چاپ ش
چت	چ ت
چته	چ ت ه
چرخ‌هایش	چرخ‌های ش
چشمم	چشم م
چشمهایش	چشمهای ش
چشمهایشان	چشمهای شان
چمنم	چمن م
چهره‌اش	چهره‌ اش
چکاره‌اند	چکاره‌ اند
چیزهاست	چیزها ست
چیزهایش	چیزهای ش
چیزیست	چیزی ست
چیست	چی ست
کارش	کار ش
کارشان	کار شان
کارم	کار م
کارند	کار ند
کارهایم	کارهای م
کارگزارانم	کارگزاران م
کتابش	کتاب ش
کتابهاشان	کتابها شان
کجاست	کجا ست
کدورتهایشان	کدورتهای شان
کردنش	کردن ش
کرم‌خورده‌اش	کرم‌خورده‌ اش
کشش	کش ش
کشورش	کشور ش
کشورشان	کشور شان
کشورمان	کشور مان
کلیشه‌هاست	کلیشه‌ها ست
کمتره	کمتر ه
کمکت	کمک ت
کمکم	کمک م
کنارش	کنار ش
کوچکش	کوچک ش
کیست	کی ست
کیفش	کیف ش
گذشته‌اند	گذشته‌ اند
گرانقدرش	گرانقدر ش
گرانقدرشان	گرانقدر شان
گردنتان	گردن تان
گردنش	گردن ش
گرفتارند	گرفتار ند
گرفتنت	گرفتن ت
گروهند	گروه ند
گریمش	گریم ش
گسترده‌اند	گسترده‌ اند
گفتارمان	گفتار مان
گلویش	گلوی ش
گناهت	گناه ت
گوشش	گوش ش
گوشم	گوش م
گولش	گول ش
یادت	یاد ت
یادتان	یاد تان
یادم	یاد م
یارانش	یاران ش
