'matarte'	' matar te '
abalanzarse	abalanzar se
abandonarlo	abandonar lo
abastecerse	abastecer se
abrazarle	abrazar le
abrirlas	abrir las
abrirle	abrir le
abrirse	abrir se
abriéndose	abriendo se
abstenerse	abstener se
aburrirse	aburrir se
accidentarse	accidentar se
aceptarlo	aceptar lo
acercarme	acercar me
acercarse	acercar se
acercándose	acercando se
aclararla	aclarar la
acogerse	acoger se
acomodarse	acomodar se
acompañarla	acompañar la
acompañarle	acompañar le
acostumbrarnos	acostumbrar nos
acostumbrarse	acostumbrar se
activarlas	activar las
actualizarse	actualizar se
acusándole	acusando le
adaptarla	adaptar la
adaptarlas	adaptar las
adaptarse	adaptar se
adaptándose	adaptando se
adecuarla	adecuar la
adelantarla	adelantar la
adelantarle	adelantar le
adelantarse	adelantar se
adentrarse	adentrar se
adjudicarse	adjudicar se
admirarlo	admirar lo
adoptarla	adoptar la
adoptarse	adoptar se
adormecerse	adormecer se
adquirirlas	adquirir las
advertirle	advertir le
afeitárselo	afeitar se
afianzarse	afianzar se
afiliarse	afiliar se
afirmarlo	afirmar lo
afrontándolo	afrontando lo
agacharse	agachar se
agarrarlo	agarrar lo
agarrarse	agarrar se
agradecerles	agradecer les
agredirlo	agredir lo
aguantarlos	aguantar los
aguarnos	aguar nos
ahincarnos	ahincar nos
ahogarse	ahogar se
ahorrarse	ahorrar se
ajustarse	ajustar se
alargarse	alargar se
alcanzarla	alcanzar la
alcanzarlo	alcanzar lo
alejarse	alejar se
aliarse	aliar se
alimentarla	alimentar la
alimentarse	alimentar se
alistarse	alistar se
alzarse	alzar se
alzándose	alzando se
amargarle	amargar le
amarrarles	amarrar les
ampliarse	ampliar se
amándose	amando se
analizarlos	analizar los
anotarse	anotar se
anticiparnos	anticipar nos
anunciarnos	anunciar nos
apartarse	apartar se
aplazarse	aplazar se
aplicarle	aplicar le
aplicarlo	aplicar lo
aplicarlos	aplicar los
aplicarse	aplicar se
aplicárseles	aplicar se
aportarle	aportar le
apoyarla	apoyar la
apoyándose	apoyando se
apreciarse	apreciar se
apresurarse	apresurar se
aprobarlas	aprobar las
aprobarse	aprobar se
aprovecharnos	aprovechar nos
aprovechándose	aprovechando se
aprovisionarse	aprovisionar se
aproximarse	aproximar se
arañándose	arañando se
arraigarse	arraigar se
arrancarle	arrancar le
arrancándose	arrancando se
arrebatarle	arrebatar le
arrebatándole	arrebatando le
arrebatándoles	arrebatando les
arrebatándoselo	arrebatando se
arreglarla	arreglar la
arreglarle	arreglar le
arreglarlo	arreglar lo
arrepentirse	arrepentir se
arrestarlo	arrestar lo
arrestarlos	arrestar los
arrojarse	arrojar se
arruinarme	arruinar me
arrullándose	arrullando se
asegurarle	asegurar le
asegurarse	asegurar se
asegurándole	asegurando le
asesinarle	asesinar le
asilarse	asilar se
asociarse	asociar se
asomarse	asomar se
atarse	atar se
atenerse	atener se
atenuarse	atenuar se
atraparlas	atrapar las
atreverse	atrever se
atribuirla	atribuir la
atribuirles	atribuir les
aturdirse	aturdir se
aumentarlos	aumentar los
autogenerarse	autogenerar se
auxiliarlas	auxiliar las
avisarlo	avisar lo
ayudarla	ayudar la
ayudarle	ayudar le
ayudarles	ayudar les
ayudarlo	ayudar lo
ayudarlos	ayudar los
ayudarse	ayudar se
añadirles	añadir les
añadirse	añadir se
añádale	añada le
basarse	basar se
basándose	basando se
beneficiarse	beneficiar se
burlarse	burlar se
buscarla	buscar la
buscarse	buscar se
buscándola	buscando la
caerse	caer se
calentarle	calentar le
calificarse	calificar se
callarme	callar me
callarse	callar se
cambiarla	cambiar la
cambiarlas	cambiar las
cambiarlo	cambiar lo
camuflarse	camuflar se
canalizarse	canalizar se
canturrearle	canturrear le
cantándola	cantando la
capacitarse	capacitar se
casarnos	casar nos
casarse	casar se
causarle	causar le
causarlos	causar los
celebrarse	celebrar se
centrarse	centrar se
centrándose	centrando se
cepillarle	cepillar le
cerrarla	cerrar la
cerrarlas	cerrar las
cerrarlo	cerrar lo
cerrarse	cerrar se
ciscarse	ciscar se
clasificarse	clasificar se
colapsarse	colapsar se
coleccionándolas	coleccionando las
colgarse	colgar se
colmarlos	colmar los
colocarlo	colocar lo
colocarnos	colocar nos
colocarse	colocar se
colocándose	colocando se
combatirlo	combatir lo
comercializarse	comercializar se
comerciarse	comerciar se
compararse	comparar se
compensarle	compensar le
complementarse	complementar se
completarla	completar la
completarse	completar se
comportarme	comportar me
comportarse	comportar se
comprarle	comprar le
comprarse	comprar se
comprarte	comprar te
comprobarlo	comprobar lo
comprobarse	comprobar se
comprometerse	comprometer se
comunicarle	comunicar le
comunicarse	comunicar se
concebirse	concebir se
concederle	conceder le
concederse	conceder se
concediéndole	concediendo le
concentrarse	concentrar se
concluirse	concluir se
concretarnos	concretar nos
concretarse	concretar se
conducirlo	conducir lo
conectarse	conectar se
confesarse	confesar se
confiarse	confiar se
configurarse	configurar se
confirmarse	confirmar se
conformarse	conformar se
conformándose	conformando se
confortarse	confortar se
confrontarlo	confrontar lo
confundirla	confundir la
confundirse	confundir se
congraciarles	congraciar les
conocerlo	conocer lo
conocerse	conocer se
conseguirlo	conseguir lo
conseguirlos	conseguir los
conseguirse	conseguir se
considerarla	considerar la
considerarle	considerar le
considerarlo	considerar lo
considerarse	considerar se
consolarlo	consolar lo
constituirse	constituir se
construirse	construir se
contarles	contar les
contarme	contar me
contarte	contar te
contenerlo	contener lo
controlarlo	controlar lo
convencerle	convencer le
convencerles	convencer les
convertirla	convertir la
convertirle	convertir le
convertirlo	convertir lo
convertirlos	convertir los
convertirse	convertir se
convirtiéndose	convirtiendo se
corregirlo	corregir lo
correrse	correr se
costarle	costar le
costearse	costear se
crearse	crear se
creerlo	creer lo
creerse	creer se
cruzarse	cruzar se
cruzándolos	cruzando los
créame	crea me
cuente	cuen te
cumplirse	cumplir se
cumpliéndose	cumpliendo se
darla	dar la
darle	dar le
darles	dar les
darme	dar me
darnos	dar nos
darse	dar se
deberme	deber me
deberse	deber se
decantarse	decantar se
decantándose	decantando se
decidirlo	decidir lo
decidirse	decidir se
decirlas	decir las
decirle	decir le
decirles	decir les
decirlo	decir lo
decirme	decir me
decirse	decir se
decirte	decir te
declararse	declarar se
declarándose	declarando se
dedicarse	dedicar se
dedíquense	dediquen se
defenderla	defender la
defenderle	defender le
defenderlo	defender lo
defenderse	defender se
dejarla	dejar la
dejarlo	dejar lo
dejarlos	dejar los
dejarnos	dejar nos
dejarse	dejar se
dejándolas	dejando las
dejándole	dejando le
dejándolo	dejando lo
deletrearle	deletrear le
demorarse	demorar se
demostrarles	demostrar les
demostrarse	demostrar se
denunciarlas	denunciar las
derribarla	derribar la
desacelerándose	desacelerando se
desahogarse	desahogar se
desalojarla	desalojar la
desarrollarla	desarrollar la
desarrollarse	desarrollar se
desarrollándose	desarrollando se
desbordarla	desbordar la
desconectarse	desconectar se
desconocerlas	desconocer las
describirlos	describir los
descubrirle	descubrir le
descubrirlo	descubrir lo
desearles	desear les
desenvolverse	desenvolver se
desestimarse	desestimar se
deseándole	deseando le
deshacerse	deshacer se
desmarcarse	desmarcar se
desnudarse	desnudar se
despedirse	despedir se
despejarse	despejar se
despertarle	despertar le
desplazarse	desplazar se
desplazarte	desplazar te
despojarlo	despojar lo
despojándolo	despojando lo
desprenderse	desprender se
destacarse	destacar se
destruirle	destruir le
destruirlos	destruir los
desvirgarse	desvirgar se
detectarse	detectar se
detenerla	detener la
detenerles	detener les
detenerse	detener se
deteriorarse	deteriorar se
devolverlas	devolver las
devolverme	devolver me
devolverte	devolver te
devolviéndola	devolviendo la
devorarla	devorar la
devuélvenos	devuelve nos
diciéndole	diciendo le
diciéndoles	diciendo les
diferenciarse	diferenciar se
diluyéndose	diluyendo se
dinamizarse	dinamizar se
dirigirla	dirigir la
dirigirles	dirigir les
dirigirse	dirigir se
dirigiéndome	dirigiendo me
disculparse	disculpar se
discutirle	discutir le
discutirse	discutir se
diseñarse	diseñar se
disfrutarla	disfrutar la
dispersarse	dispersar se
disputarlo	disputar lo
disputarse	disputar se
distanciarse	distanciar se
distinguirlos	distinguir los
distinguirse	distinguir se
distraerme	distraer me
divirtiéndome	divirtiendo me
divulgarlo	divulgar lo
doblegarle	doblegar le
dormirse	dormir se
dotarla	dotar la
dotarlo	dotar lo
dotarse	dotar se
drogándose	drogando se
dándole	dando le
dándolo	dando lo
echarle	echar le
echarlo	echar lo
echarme	echar me
echarse	echar se
ejecutarlo	ejecutar lo
ejecutarse	ejecutar se
elegirse	elegir se
elevarse	elevar se
elevándose	elevando se
eliminarlo	eliminar lo
emitirlo	emitir lo
emocionarse	emocionar se
empeñándose	empeñando se
emplearse	emplear se
encerrarlo	encerrar lo
encerrarse	encerrar se
encomendarla	encomendar la
encontrarle	encontrar le
encontrarme	encontrar me
encontrarnos	encontrar nos
encontrarse	encontrar se
enderezarse	enderezar se
enfocarse	enfocar se
enfrentarles	enfrentar les
enfrentarnos	enfrentar nos
enfrentarse	enfrentar se
enfrentándose	enfrentando se
engancharse	enganchar se
engañarnos	engañar nos
enmarcarlo	enmarcar lo
enrolarse	enrolar se
ensanchándose	ensanchando se
entenderlo	entender lo
entenderlos	entender los
entendernos	entender nos
entenderse	entender se
enterarme	enterar me
entregarlas	entregar las
entregarlo	entregar lo
entregarse	entregar se
entrenarse	entrenar se
entrenándose	entrenando se
entrevistarse	entrevistar se
enviarse	enviar se
equilibrándose	equilibrando se
equivocarme	equivocar me
equivocarse	equivocar se
erigirse	erigir se
escamotearle	escamotear le
escaparse	escapar se
escindirse	escindir se
esconderse	esconder se
esconderte	esconder te
escucharse	escuchar se
escudriñarlas	escudriñar las
escurrirse	escurrir se
esforzarse	esforzar se
esforzándonos	esforzando nos
esforzándose	esforzando se
especializarse	especializar se
esperarse	esperar se
esperándole	esperando le
establecerse	establecer se
estamparle	estampar le
estarlo	estar lo
estorbarse	estorbar se
estrellarse	estrellar se
estrenarla	estrenar la
estudiarlo	estudiar lo
evadirse	evadir se
evaluarlo	evaluar lo
evitarlas	evitar las
evitarle	evitar le
evitarse	evitar se
examinarla	examinar la
exigiendose	exigiendo se
exigirnos	exigir nos
exigirse	exigir se
exigiéndolos	exigiendo los
explicarles	explicar les
explicarlo	explicar lo
explicarnos	explicar nos
explicarse	explicar se
explotarla	explotar la
exponerle	exponer le
expresarle	expresar le
expresarse	expresar se
expulsarlo	expulsar lo
extenderse	extender se
externalizarse	externalizar se
extinguirse	extinguir se
extorsionarle	extorsionar le
extractarlas	extractar las
fabricarse	fabricar se
fabricándolas	fabricando las
familiarizarse	familiarizar se
felicitarnos	felicitar nos
fijarse	fijar se
financiarlos	financiar los
formarse	formar se
fracturarse	fracturar se
frenarlo	frenar lo
frotarlas	frotar las
fugarse	fugar se
fulminarle	fulminar le
fíjate	fija te
fíjense	fijen se
ganarle	ganar le
ganarlo	ganar lo
ganarnos	ganar nos
ganarse	ganar se
ganárselo	ganar se
golpearle	golpear le
guardarlo	guardar lo
guárdese	guarde se
haberla	haber la
haberlas	haber las
haberlo	haber lo
haberlos	haber los
haberme	haber me
haberse	haber se
habituarnos	habituar nos
hablarse	hablar se
hacerla	hacer la
hacerlas	hacer las
hacerle	hacer le
hacerles	hacer les
hacerlo	hacer lo
hacernos	hacer nos
hacerse	hacer se
haciéndolo	haciendo lo
haciéndose	haciendo se
hallarle	hallar le
hallarse	hallar se
hazlo	haz lo
haznos	haz nos
hincarle	hincar le
hundirse	hundir se
identificarles	identificar les
identificarlo	identificar lo
identificarse	identificar se
imaginaros	imaginar os
imaginarse	imaginar se
imagínense	imaginen se
impedirlo	impedir lo
imponerse	imponer se
imponiéndose	imponiendo se
importarlos	importar los
incomodarlo	incomodar lo
incorporarla	incorporar la
incorporarse	incorporar se
incrementarse	incrementar se
individualizarse	individualizar se
inferirse	inferir se
informarle	informar le
informarse	informar se
iniciarse	iniciar se
inmutarse	inmutar se
inquietarse	inquietar se
inscribirse	inscribir se
insinuarle	insinuar le
inspirándose	inspirando se
instalarse	instalar se
instruirse	instruir se
insultarle	insultar le
insultarse	insultar se
integrarse	integrar se
interesarse	interesar se
interesándose	interesando se
intimidarlo	intimidar lo
introducirse	introducir se
investigarla	investigar la
investigarse	investigar se
irguiéndose	irguiendo se
irme	ir me
irse	ir se
jubilarse	jubilar se
jugarse	jugar se
jugársela	jugar se
justificarla	justificar la
juzgarlo	juzgar lo
lanzarla	lanzar la
lanzarse	lanzar se
lanzándole	lanzando le
lavarse	lavar se
leerla	leer la
leerlo	leer lo
lesionarse	lesionar se
levantarle	levantar le
levantarme	levantar me
levantarse	levantar se
levantándose	levantando se
liarme	liar me
liberarlo	liberar lo
liberarlos	liberar los
liberarse	liberar se
liberándolas	liberando las
librarse	librar se
limitarse	limitar se
limitándose	limitando se
limpiarse	limpiar se
limpiándose	limpiando se
lincharla	linchar la
liquidarle	liquidar le
llamarle	llamar le
llamarlo	llamar lo
llamarse	llamar se
llamándose	llamando se
llegarse	llegar se
llegándose	llegando se
llenarse	llenar se
llevarla	llevar la
llevarlo	llevar lo
llevarlos	llevar los
llevarme	llevar me
llevarnos	llevar nos
llevarse	llevar se
llevándolos	llevando los
llámense	llamen se
lograrlo	lograr lo
lograrse	lograr se
léase	lea se
mancillarles	mancillar les
mandarlo	mandar lo
manejarse	manejar se
manifestarme	manifestar me
manifestarnos	manifestar nos
manifestarse	manifestar se
manipularlos	manipular los
manipularse	manipular se
mantenerla	mantener la
mantenerlas	mantener las
mantenerlos	mantener los
mantenerme	mantener me
mantenerse	mantener se
mantengámoslos	mantengamos los
manteniéndose	manteniendo se
maquillarse	maquillar se
marcarles	marcar les
marcharnos	marchar nos
marcharse	marchar se
materializarse	materializar se
mejorarlas	mejorar las
mejorarlo	mejorar lo
mencionarlos	mencionar los
mentalizarse	mentalizar se
meterse	meter se
mirarle	mirar le
mirarme	mirar me
mirándonos	mirando nos
morderle	morder le
mortificarla	mortificar la
mostrarse	mostrar se
moverse	mover se
movilizarse	movilizar se
multiplicarse	multiplicar se
negarme	negar me
negarse	negar se
negándola	negando la
negándole	negando le
negándose	negando se
notarse	notar se
obligarlas	obligar las
obsesionarte	obsesionar te
ocultarlo	ocultar lo
ocultándoles	ocultando les
ocuparse	ocupar se
ocupándose	ocupando se
ofrecerle	ofrecer le
ofreciéndole	ofreciendo le
olvidarme	olvidar me
olvidarnos	olvidar nos
olvidarse	olvidar se
olvidarte	olvidar te
olvidándose	olvidando se
oponernos	oponer nos
organizarse	organizar se
oírse	oir se
pactarse	pactar se
pararse	parar se
parecerlo	parecer lo
parecerse	parecer se
pasarla	pasar la
pasarlo	pasar lo
pasarte	pasar te
pedirla	pedir la
pedirle	pedir le
pegarla	pegar la
penalizarse	penalizar se
pensarlo	pensar lo
perderlas	perder las
perderse	perder se
perdiéndose	perdiendo se
permitirles	permitir les
permitirse	permitir se
pidiéndonos	pidiendo nos
plantarse	plantar se
plantearse	plantear se
plantearselo	plantear se
planteárnoslo	plantear nos
poderle	poder le
ponerla	poner la
ponerlo	poner lo
ponerme	poner me
ponernos	poner nos
ponerse	poner se
poniéndolo	poniendo lo
posicionarse	posicionar se
practicarla	practicar la
precipitarla	precipitar la
precipitarse	precipitar se
preguntarle	preguntar le
preguntarlo	preguntar lo
preguntarse	preguntar se
preguntándose	preguntando se
preocuparse	preocupar se
prepararla	preparar la
prepararle	preparar le
prepararlo	preparar lo
prepararse	preparar se
preparándose	preparando se
presentarla	presentar la
presentarle	presentar le
presentarse	presentar se
prestarse	prestar se
prevenirnos	prevenir nos
preverlo	prever lo
proclamarlo	proclamar lo
proclamarse	proclamar se
procurarse	procurar se
producirse	producir se
prolongarse	prolongar se
promocionarla	promocionar la
pronunciarse	pronunciar se
propagarse	propagar se
proponerse	proponer se
proporcionarle	proporcionar le
prostituirse	prostituir se
protegerlos	proteger los
protegiéndose	protegiendo se
proveerse	proveer se
proyectarles	proyectar les
publicarlas	publicar las
pudiéndolo	pudiendo lo
pudiéndose	pudiendo se
párate	para te
quedarme	quedar me
quedarse	quedar se
quejarse	quejar se
quemarla	quemar la
quemarlas	quemar las
quererle	querer le
querernos	querer nos
quitarle	quitar le
quitarles	quitar les
rasgarse	rasgar se
realizarse	realizar se
reanimarse	reanimar se
reanudarse	reanudar se
rebajarlos	rebajar los
recalificarlo	recalificar lo
recibirlas	recibir las
recibirles	recibir les
reciclarlos	reciclar los
reciclarme	reciclar me
recobrarla	recobrar la
recogerlo	recoger lo
reconciliarse	reconciliar se
reconocerse	reconocer se
reconociéndola	reconociendo la
reconstruirme	reconstruir me
reconócete	reconoce te
recordarlo	recordar lo
recorrerla	recorrer la
recuperarlo	recuperar lo
recuperarme	recuperar me
recuperarnos	recuperar nos
recuperarse	recuperar se
recuperándose	recuperando se
redistribuirlas	redistribuir las
reducirlo	reducir lo
reducirse	reducir se
reencontrarse	reencontrar se
referirme	referir me
referirse	referir se
refiriéndose	refiriendo se
reflotarlos	reflotar los
reforzarla	reforzar la
reforzarlas	reforzar las
regalarle	regalar le
regalarles	regalar les
registrarse	registrar se
regularizarse	regularizar se
regularlos	regular los
rehacerse	rehacer se
reirse	reir se
relevándolos	relevando los
remitirse	remitir se
rendirme	rendir me
rendirse	rendir se
repararse	reparar se
repartirse	repartir se
repetirlo	repetir lo
repetirse	repetir se
replantarlos	replantar los
replantearse	replantear se
reponerse	reponer se
reportarle	reportar le
reproducirse	reproducir se
resaltarse	resaltar se
resarcirse	resarcir se
resentirse	resentir se
reservarnos	reservar nos
resistirse	resistir se
resolverse	resolver se
respetarse	respetar se
responsabilizarse	responsabilizar se
restarlos	restar los
resultarnos	resultar nos
resumirla	resumir la
resumirse	resumir se
retirarlas	retirar las
retirarlo	retirar lo
retirarse	retirar se
reubicarlos	reubicar los
reunirme	reunir me
reunirse	reunir se
reuniéndose	reuniendo se
revelarlo	revelar lo
rezarle	rezar le
riéndose	riendo se
robarle	robar le
robustecerse	robustecer se
robándole	robando le
rodearle	rodear le
rodearse	rodear se
romperle	romper le
romperse	romper se
saberlo	saber lo
sacarles	sacar les
sacarlo	sacar lo
salirse	salir se
saltarse	saltar se
saludarlos	saludar los
saludarme	saludar me
secándose	secando se
seguirle	seguir le
seguirlos	seguir los
sentarse	sentar se
sentarte	sentar te
sentirme	sentir me
sentirnos	sentir nos
sentirse	sentir se
serle	ser le
serlo	ser lo
servirle	servir le
servirme	servir me
servirnos	servir nos
señalándole	señalando le
situarla	situar la
situarse	situar se
situándose	situando se
sobornarle	sobornar le
sobreponerse	sobreponer se
sobreponiéndose	sobreponiendo se
solaparse	solapar se
soldarse	soldar se
solidarizarse	solidarizar se
solucionarle	solucionar le
solucionarlo	solucionar lo
solucionarlos	solucionar los
solventarse	solventar se
someterme	someter me
someterse	someter se
sonrojarse	sonrojar se
sorprenderse	sorprender se
suavizarlas	suavizar las
subirlos	subir los
sucederle	suceder le
suicidarse	suicidar se
sujetarle	sujetar le
sumarse	sumar se
sumergirse	sumergir se
superarla	superar la
superarle	superar le
superarlo	superar lo
superponiéndose	superponiendo se
suplicarle	suplicar le
suspenderse	suspender se
sustraerse	sustraer se
sépalo	sepa lo
tararearlo	tararear lo
tenerla	tener la
tenerlo	tener lo
tenerlos	tener los
terminarlo	terminar lo
tirarla	tirar la
tocarles	tocar les
tocarlo	tocar lo
tomarla	tomar la
tomarnos	tomar nos
tomarse	tomar se
tomándose	tomando se
torcerse	torcer se
tragarse	tragar se
tramitarse	tramitar se
tranquilizarles	tranquilizar les
tranquilícese	tranquilice se
transformarse	transformar se
transportarlo	transportar lo
trasladarse	trasladar se
trasladándose	trasladando se
trasmitirle	trasmitir le
traspasarlo	traspasar lo
tratarse	tratar se
tumbarse	tumbar se
unirme	unir me
unirse	unir se
usarlos	usar los
usarse	usar se
utilizarlos	utilizar los
utilizaros	utilizar os
utilizarse	utilizar se
vencerlos	vencer los
venderla	vender la
vendérsela	vender se
vengarse	vengar se
ventilarse	ventilar se
verla	ver la
verle	ver le
verlo	ver lo
verlos	ver los
verme	ver me
verse	ver se
vestirme	vestir me
vete	ve te
veámoslo	veamos lo
vincularlas	vincular las
visitarnos	visitar nos
vitorearlo	vitorear lo
volcarse	volcar se
volverlo	volver lo
volverlos	volver los
volverme	volver me
volvernos	volver nos
volverse	volver se
véase	vea se
vérselas	ver se
yéndose	yendo se
zafarse	zafar se
zurrarle	zurrar le
