'francisco	' francisco
'garcía	' garcía
'gianni	' gianni
'guerra	' guerra
(...)	( ... )
acadalo	acadar lo
aceptouse	aceptou se
achegarse	achegar se
achegouse	achegou se
achégase	achega se
acompañouno	acompañou no
adaptarse	adaptar se
adicarlles	adicar lles
adiántanse	adiantan se
adquirirse	adquirir se
adícase	adica se
afórranse	aforran se
amósasenos	amosa se nos
ao	a o
aos	a os
apoiarnos	apoiar nos
aprenderlles	aprender lles
aprendéndoa	aprendendo a
aprobarse	aprobar se
aqueloutros	aqueles outros
arrédase	arreda se
asasináronlle	asasinaron lle
barros'	barros '
buscarlle	buscar lle
bátelle	bate lle
bótase	bota se
campos'	campos' '
captouna	captou na
citroën-zona	citroën - zona
co	con o
coa	con a
coas	con as
collerlle	coller lle
complícase	complica se
concederse	conceder se
concedíalle	concedía lle
considéroo	considero o
construíanse	construían se
constrúese	constrúe se
corresponderalle	corresponderá lle
corrixíame	corrixía me
coruña-ferrol	coruña - ferrol
cos	con os
créanse	crean se
créase	crea se
cun	con un
cunha	con unha
cunhas	con unhas
cúmprense	cumpren se
da	de a
dalgún	de algún
daquel	de aquel
daquela	de aquela
darlle	dar lle
darse	dar se
das	de as
decateime	decatei me
declárase	declara se
dedicarlle	dedicar lle
dela	de ela
delas	de elas
deles	de eles
derivarse	derivar se
desa	de esa
dese	de ese
desenvolvíanse	desenvolvían se
deses	de eses
desnúdanse	desnudan se
desta	de esta
destas	de estas
deste	de este
destes	de estes
deunos	deu nos
dicirse	dicir se
dinos	di nos
dirixiuse	dirixiu se
disto	de isto
do	de o
dominalo	dominar lo
dos	de os
dotaraos	dotará os
doutra	de outra
doutras	de outras
doutro	de outro
doutros	de outros
dun	de un
dunha	de unha
dunhas	de unhas
dáse	dá se
débese	debe se
dígame	diga me
dígolle	digo lle
dótase	dota se
empaparme	empapar me
ensinábame	ensinaba me
entendelo	entender lo
entenderse	entender se
esforzouse	esforzou se
estendeuse	estendeu se
estrañarnos	estrañar nos
estreouse	estreou se
esváense	esvaen se
excluílo	excluír lo
explícalle	explica lle
facerlle	facer lle
facernos	facer nos
facerse	facer se
factúranse	facturan se
facíame	facía me
faino	fai no
fixarse	fixar se
forzouno	forzou no
fáleme	fale me
galicia-norte	galicia - norte
galiza-norte	galiza - norte
gostaríame	gostaría me
gustaríame	gustaría me
gástase	gasta se
gústalle	gusta lle
gústame	gusta me
hainos	hai nos
instáurase	instaura se
integrándoo	integrando o
interesarse	interesar se
lanza'	lanza '
levántase	levanta se
limitarse	limitar se
mantense	mantén se
meterse	meter se
moéndonos	moendo nos
na	en a
naquel	en aquel
naquela	en aquela
naqueles	en aqueles
nas	en as
nel	en el
nesa	en esa
nesta	en esta
nestas	en estas
neste	en este
nestes	en estes
no	en o
nolo	nos lo
nos	en os
noutra	en outra
noutro	en outro
noutros	en outros
nun	en un
nunha	en unha
nunhas	en unhas
ocupalos	ocupar los
ofreceulle	ofreceu lle
ofrécese	ofrece se
opoñerse	opoñer se
parecelo	parecer lo
perdelo	perder lo
pola	por la
polas	por las
polo	por lo
polos	por los
privarse	privar se
producíndose	producindo se
proponse	propón se
quedaríalle	quedaría lle
queixáronse	queixaron se
quéixanse	queixan se
ramifícase	ramifica se
recoñecerlle	recoñecer lle
recrealo	recrear lo
referíndose	referindo se
refírese	refire se
regábanse	regaban se
remátase	remata se
representarnos	representar nos
reuniuse	reuniu se
rexuveneceuse	rexuveneceu se
rodari'	rodari '
roubalo	roubar lo
selo	ser lo
sentirse	sentir se
simplificouna	simplificou na
solicitoulle	solicitou lle
sorprendeunos	sorprendeu nos
sorríronlle	sorriron lle
sustentalo	sustentar lo
sácano	sacan o
teno	ten o
teríao	tería o
trabállase	traballa se
traicionalo	traicionar lo
trátase	trata se
usalos	usar los
utilizábase	utilizaba se
utilizáronse	utilizaron se
vernos	ver nos
vese	ve se
vigo-pontevedra	vigo - pontevedra
vémonos	vemos nos
véndonos	vendo nos
véxoa	vexo a
á	a a
ás	a as
úsase	usa se
