accontentarci	accontentar ci
adattarsi	adattar si
adoperarsi	adoperar si
adottarlo	adottar lo
affermarsi	affermar si
agli	a gli
ai	a i
aiutarle	aiutar le
aiutarli	aiutar li
al	a il
all'	a l'
alla	a la
alle	a le
allo	a lo
allontanandosi	allontanando si
appropriandosi	appropriando si
assicurati	assicura ti
avvicinarsi	avvicinar si
basarsi	basar si
candidarsi	candidar si
chiamarle	chiamar le
coi	con i
col	con il
combinarlo	combinar lo
comportarsi	comportar si
considerandoli	considerando li
controllarle	controllar le
crearla	crear la
dagli	da gli
dai	da i
dal	da il
dall'	da l'
dalla	da la
dalle	da le
dallo	da lo
definendolo	definendo lo
degli	di gli
dei	di i
del	di il
dell'	di l'
della	di la
delle	di le
dello	di lo
dirlo	dir lo
eliminarle	eliminar le
esprimersi	esprimer si
esserci	esser ci
esserlo	esser lo
essersi	esser si
facilitarne	facilitar ne
farle	far le
farli	far li
farlo	far lo
farsi	far si
farvi	far vi
fermarsi	fermar si
figuriamoci	figuriamo ci
finirlo	finir lo
impegnarsi	impegnar si
includervi	includer vi
incoraggiarli	incoraggiar li
indurlo	indur lo
integrarsi	integrar si
lasciarle	lasciar le
leggersi	legger si
manifestarsi	manifestar si
mantenerne	mantener ne
migliorarne	migliorar ne
muoversi	muover si
negli	in gli
nei	in i
nel	in il
nell'	in l'
nella	in la
nelle	in le
nello	in lo
nutrirne	nutrir ne
occupandosi	occupando si
occuparsi	occupar si
opporsi	oppor si
osservandolo	osservando lo
pagarne	pagar ne
paragonarsi	paragonar si
permettersi	permetter si
porsi	por si
poterti	poter ti
prendersi	prender si
procurarsi	procurar si
pronunciarsi	pronunciar si
recarsi	recar si
renderla	render la
rendersi	render si
rifugiandosi	rifugiando si
rivelarsi	rivelar si
rivolgersi	rivolger si
sorprendersi	sorprender si
sostenerle	sostener le
sovrapporsi	sovrappor si
sovvertirlo	sovvertir lo
spingersi	spinger si
sposarsi	sposar si
sugli	su gli
sui	su i
suicidarsi	suicidar si
sul	su il
sull'	su l'
sulla	su la
sulle	su le
sullo	su lo
tenerla	tener la
trasformarsi	trasformar si
trovarla	trovar la
unitosi	unito si
vederli	veder li
verificatisi	verificati si
