abym	aby m
abyś	aby ś
bałem	bał em
braliśmy	brali śmy
brałam	brała m
broniliśmy	bronili śmy
byliby	byli by
byliśmy	byli śmy
bym	by m
byłaby	była by
byłam	była m
byłby	był by
byłbym	był by m
byłem	był em
byłeś	był eś
byłoby	było by
byłyby	były by
byłyśmy	były śmy
byśmy	by śmy
błyszczeliśmy	błyszczeli śmy
chciałaby	chciała by
chciałabym	chciała by m
chciałam	chciała m
chciałaś	chciała ś
chciałby	chciał by
chciałbym	chciał by m
chciałem	chciał em
czekałem	czekał em
czułem	czuł em
czytałem	czytał em
dawaliśmy	dawali śmy
dopisywałoby	dopisywało by
dostałam	dostała m
dostałaś	dostała ś
dostałem	dostał em
dostrzegłem	dostrzegł em
doszliśmy	doszli śmy
doszłem	doszł em
dotarliśmy	dotarli śmy
dotykaliśmy	dotykali śmy
dowiedziałem	dowiedział em
dzwoniłeś	dzwonił eś
gdybym	gdyby m
gdybyś	gdyby ś
godziłem	godził em
groziłem	groził em
groziłoby	groziło by
kierowaliśmy	kierowali śmy
kroczyliśmy	kroczyli śmy
kręciliśmy	kręcili śmy
kupiliśmy	kupili śmy
kupiłam	kupiła m
kupiłbym	kupił by m
kupiłem	kupił em
leżeliśmy	leżeli śmy
martwiłem	martwił em
miałabyś	miała by ś
miałam	miała m
miałby	miał by
miałem	miał em
miałeś	miał eś
mieliśmy	mieli śmy
mogliby	mogli by
mogliśmy	mogli śmy
mogłaby	mogła by
mogłabym	mogła by m
mogłam	mogła m
mogłem	mogł em
mogłyby	mogły by
musiałbym	musiał by m
musiałem	musiał em
musiałeś	musiał eś
myliłem	mylił em
myślałam	myślała m
myślałem	myślał em
myśleliście	myśleli ście
mógłby	mógł by
mógłbym	mógł by m
mógłbyś	mógł by ś
mówiłam	mówiła m
mówiłem	mówił em
mówiłeś	mówił eś
nacisnąłem	nacisnął em
nadziałem	nadział em
nakazywałby	nakazywał by
należałoby	należało by
napełniłem	napełnił em
napisałaby	napisała by
napisałem	napisał em
napisałeś	napisał eś
napiłbym	napił by m
natknęłam	natknęła m
natrafiliśmy	natrafili śmy
nauczyłem	nauczył em
obawiałem	obawiał em
obiecałem	obiecał em
obiecywaliście	obiecywali ście
obijaliśmy	obijali śmy
odebraliście	odebrali ście
odkryłam	odkryła m
odnalazłem	odnalazł em
odpowiadałby	odpowiadał by
odpowiedziałem	odpowiedział em
odpowiedziałeś	odpowiedział eś
odszedłem	odszedł em
odwiedziłem	odwiedził em
odwoływałem	odwoływał em
oglądaliśmy	oglądali śmy
okrążyłem	okrążył em
opłaciłam	opłaciła m
oscylowałem	oscylował em
otworzyłam	otworzyła m
otworzyłem	otworzył em
ośmieliłbym	ośmielił by m
paliłem	palił em
patrzyłem	patrzył em
piliśmy	pili śmy
pisaliśmy	pisali śmy
pobiegłam	pobiegła m
pobiegłem	pobiegł em
pocałowaliśmy	pocałowali śmy
pociągnąłem	pociągnął em
poczułam	poczuła m
poczułeś	poczuł eś
podaliśmy	podali śmy
podałem	podał em
podejrzałem	podejrzał em
podesłałeś	podesłał eś
podnieśliśmy	podnieśli śmy
podniosłem	podniosł em
podpisałem	podpisał em
podpisałyby	podpisały by
podporządkowywałem	podporządkowywał em
podrzuciłem	podrzucił em
podskoczyłem	podskoczył em
podążałeś	podążał eś
podłączyliśmy	podłączyli śmy
pojechałem	pojechał em
pokiwałem	pokiwał em
pomagaliśmy	pomagali śmy
pomyślałem	pomyślał em
poprawiłam	poprawiła m
poprzestałem	poprzestał em
poradziliby	poradzili by
poruszyłem	poruszył em
posadziłam	posadziła m
postanowiłam	postanowiła m
postanowiłem	postanowił em
postawiłem	postawił em
poszedłbym	poszedł by m
poszliśmy	poszli śmy
poszukiwaliśmy	poszukiwali śmy
poszłabym	poszła by m
poszłam	poszła m
poszłem	poszł em
posłałam	posłała m
posłałem	posłał em
posłuchałem	posłuchał em
potrafiłam	potrafiła m
potrząsnąłem	potrząsnął em
potłumiłbym	potłumił by m
powiedziałaś	powiedziała ś
powinieneś	powinien eś
powinnam	powinna m
powinniśmy	powinni śmy
poznaliśmy	poznali śmy
pozostałoby	pozostało by
pozwoliłbyś	pozwolił by ś
położyłem	położył em
prosiłem	prosił em
prowadziłoby	prowadziło by
przedłożyłem	przedłożył em
przegraliście	przegrali ście
przegrałeś	przegrał eś
przeklinałem	przeklinał em
przekroczyłby	przekroczył by
przeprowadziłem	przeprowadził em
przerwałem	przerwał em
przesadziłem	przesadził em
przeżywałam	przeżywała m
przeżyłem	przeżył em
przycisnąłem	przycisnął em
przyciągnąłem	przyciągnął em
przydałoby	przydało by
przyjechałem	przyjechał em
przypłaciłby	przypłacił by
przystąpiliśmy	przystąpili śmy
przyszłem	przyszł em
przytrzymałem	przytrzymał em
próbowałem	próbował em
pytałeś	pytał eś
pękaliśmy	pękali śmy
płaciliśmy	płacili śmy
radziłabym	radziła by m
rozejrzałem	rozejrzał em
roześmieliśmy	roześmieli śmy
rozglądałem	rozglądał em
rozmawialiśmy	rozmawiali śmy
rozmawiałam	rozmawiała m
rozmawiałem	rozmawiał em
rozmawiałeś	rozmawiał eś
rozpatrzyliśmy	rozpatrzyli śmy
ruszyłem	ruszył em
rzuciłem	rzucił em
schodziłem	schodził em
siadłem	siadł em
siedziałam	siedziała m
siedzieliśmy	siedzieli śmy
sięgnąłem	sięgnął em
skierowałem	skierował em
skończyłam	skończyła m
skończyłby	skończył by
skończyłem	skończył em
skradałem	skradał em
skupiliśmy	skupili śmy
skutkowałoby	skutkowało by
składałby	składał by
spisywałby	spisywał by
spodziewałem	spodziewał em
spojrzałem	spojrzał em
spotkaliśmy	spotkali śmy
spotkałem	spotkał em
spotykaliśmy	spotykali śmy
spowodowałby	spowodował by
sprawdziliśmy	sprawdzili śmy
sprawdziłeś	sprawdził eś
sprawiłoby	sprawiło by
sprzedałem	sprzedał em
spytałam	spytała m
spóźniliśmy	spóźnili śmy
spędzałem	spędzał em
stawaliśmy	stawali śmy
straciłem	stracił em
straszyłem	straszył em
stwierdziłem	stwierdził em
stworzyłoby	stworzyło by
szedłem	szedł em
szperałem	szperał em
szukałem	szukał em
sądziłem	sądził em
słuchałem	słuchał em
słyszałam	słyszała m
słyszałem	słyszał em
tobyś	to by ś
trafiłem	trafił em
tropiłeś	tropił eś
ubrałam	ubrała m
uczyłem	uczył em
udaliśmy	udali śmy
uderzyłem	uderzył em
udzieliłam	udzieliła m
ufałem	ufał em
ukląkłem	ukląkł em
ulegałoby	ulegało by
umarłam	umarła m
umiałem	umiał em
umyłem	umył em
uruchamiałby	uruchamiał by
urządziłaby	urządziła by
usunąłem	usunął em
usłyszałem	usłyszał em
uważałem	uważał em
uwierzyłby	uwierzył by
uwzględniłby	uwzględnił by
uznałem	uznał em
ułożyłem	ułożył em
wahałem	wahał em
walnąłem	walnął em
wcisnąłem	wcisnął em
westchnęłam	westchnęła m
widziałam	widziała m
widziałaś	widziała ś
widziałem	widział em
widziałeś	widział eś
widziałoby	widziało by
widzieliśmy	widzieli śmy
wiedziałam	wiedziała m
wiedziałem	wiedział em
wierzyłam	wierzyła m
wierzyłem	wierzył em
wkraczaliśmy	wkraczali śmy
wolałabym	wolała by m
wpadłem	wpadł em
wplątałeś	wplątał eś
wprowadziłbym	wprowadził by m
wrosłem	wrosł em
wróciliście	wrócili ście
wróciłem	wrócił em
wróciłeś	wrócił eś
wsiadałam	wsiadała m
wstaliśmy	wstali śmy
wszedłem	wszedł em
wybrałbyś	wybrał by ś
wychowałam	wychowała m
wyciągnąłem	wyciągnął em
wyczerpaliśmy	wyczerpali śmy
wyczułem	wyczuł em
wygrałby	wygrał by
wygrałem	wygrał em
wyjechałem	wyjechał em
wyjąłem	wyjął em
wymacałem	wymacał em
wyniosłam	wyniosła m
wypadłam	wypadła m
wyparłem	wyparł em
wypiliśmy	wypili śmy
wyprodukowaliśmy	wyprodukowali śmy
wyrzekliśmy	wyrzekli śmy
wysiadaliśmy	wysiadali śmy
wysiadłem	wysiadł em
wysikałam	wysikała m
występowaliśmy	występowali śmy
wyszedłem	wyszedł em
wyszliśmy	wyszli śmy
wysłaliśmy	wysłali śmy
wytuszowałam	wytuszowała m
wziąłeś	wziął eś
wzięliście	wzięli ście
wzięłam	wzięła m
wątpiliście	wątpili ście
włączyłem	włączył em
zachowywałem	zachowywał em
zacisnąłem	zacisnął em
zaciążyłby	zaciążył by
zaczynałem	zaczynał em
zacząłem	zaczął em
zaczęliście	zaczęli ście
zaczęliśmy	zaczęli śmy
zadzwoniłem	zadzwonił em
zafundowaliśmy	zafundowali śmy
zajrzałem	zajrzał em
zajęliśmy	zajęli śmy
zaliczałam	zaliczała m
zamieniłem	zamienił em
zamierzałam	zamierzała m
zamierzałem	zamierzał em
zamknąłem	zamknął em
zamknęłaś	zamknęła ś
zanurzyłeś	zanurzył eś
zapadłaby	zapadła by
zapamiętałem	zapamiętał em
zapragnąłem	zapragnął em
zaproponowałem	zaproponował em
zaprosiłem	zaprosił em
zapytaliśmy	zapytali śmy
zapłaciłby	zapłacił by
zarzuciłem	zarzucił em
zassałem	zassał em
zastanawiałem	zastanawiał em
zastałem	zastał em
zaszedłem	zaszedł em
zatrudniłby	zatrudnił by
zauważyłam	zauważyła m
zauważyłem	zauważył em
zaważyłaby	zaważyła by
zawierałaby	zawierała by
zawiązałeś	zawiązał eś
zażądałem	zażądał em
zbiegłem	zbiegł em
zbliżałem	zbliżał em
zdałam	zdała m
zdałem	zdał em
zdeptałeś	zdeptał eś
zdołałeś	zdołał eś
zdziwilibyście	zdziwili by ście
zdążyłem	zdążył em
zebraliśmy	zebrali śmy
zerwałem	zerwał em
zeskoczyłem	zeskoczył em
zeznawałby	zeznawał by
zgasiłem	zgasił em
zgromadziliśmy	zgromadzili śmy
zjechaliśmy	zjechali śmy
zlikwidowałoby	zlikwidowało by
zmieniłem	zmienił em
znalazłam	znalazła m
znalazłbym	znalazł by m
znalazłeś	znalazł eś
znałem	znał em
znosiłem	znosił em
zobaczyłam	zobaczyła m
zobaczyłem	zobaczył em
zorientowałem	zorientował em
zostaliby	zostali by
zostaliśmy	zostali śmy
zostałaby	została by
zostałam	została m
zostałby	został by
zostałem	został em
zostałoby	zostało by
zrezygnowałam	zrezygnowała m
zrezygnowałem	zrezygnował em
zrobiliśmy	zrobili śmy
zrobiłam	zrobiła m
zrobiłem	zrobił em
zrozumiałam	zrozumiała m
zwariowaliśmy	zwariowali śmy
zwariowałaś	zwariowała ś
złapaliśmy	złapali śmy
złapałem	złapał em
złożyłem	złożył em
łapałem	łapał em
łowiłem	łowił em
ściągnąłem	ściągnął em
śmiałby	śmiał by
żałowałem	żałował em
